Transaction Number,Transaction Date,Transaction Type,Transaction Description,Debit Amount,Credit Amount,Balance,Category,Location City,Location Country
1,25/07/2022,BP,SAVE THE CHANGE,3.11,,541.43,Savings,Nottingham,UK
2,25/07/2022,DEB,LIDL GB  NOTTINGHA,15.02,,544.54,Groceries,Nottingham,UK
3,25/07/2022,DEB,NON-GBP PURCH FEE,0.5,,559.56,Others,Nottingham,UK
4,25/07/2022,DEB,NON-GBP TRANS FEE,0.37,,560.06,Others,Nottingham,UK
5,25/07/2022,DEB,TRAVELIUM LLC,12.59,,560.43,,,
6,25/07/2022,DEB,Audible UK,7.99,,573.02,Entertainment,Nottingham,UK
7,25/07/2022,FPO,MISS D WU,25.0,,581.01,Services,Nottingham,UK
8,25/07/2022,DEB,SAINSBURYS S/MKTS,35.57,,606.01,Groceries,Nottingham,UK
9,22/07/2022,DEB,LIDL GB  NOTTINGHA,18.21,,641.58,Groceries,Nottingham,UK
10,22/07/2022,DEB,Amazon.co.uk*VK6IN,13.51,,659.79,Amazon,Nottingham,UK
11,22/07/2022,FPO,MR J DOME,175.0,,673.3,Services,Nottingham,UK
12,21/07/2022,FPO,MISS D WU,35.0,,848.3,Services,Nottingham,UK
13,20/07/2022,FPO,TRADING212UK,200.0,,883.3,Investment,Nottingham,UK
14,20/07/2022,FPI,SHEILA SMITH,,390.0,1083.3,Supplementary Income,Nottingham,UK
15,20/07/2022,BP,SAVE THE CHANGE,0.65,,693.3,Savings,Nottingham,UK
16,19/07/2022,DEB,THE TERRACE CAFE M,31.35,,693.95,Dine Out,,
17,19/07/2022,BP,SAVE THE CHANGE,1.6,,725.3,Savings,Nottingham,UK
18,18/07/2022,DEB,The Corinthian,7.4,,726.9,Dine Out,Nottingham,UK
19,18/07/2022,DEB,The Corinthian,4.6,,734.3,Dine Out,Nottingham,UK
20,18/07/2022,DEB,TIGERMILK EVENTS,4.5,,738.9,Entertainment,Plymouth,UK
21,18/07/2022,DEB,UBER   *TRIP,11.9,,743.4,Travel,Plymouth,UK
22,18/07/2022,DD,VIRGIN MEDIA PYMTS,56.25,,755.3,Bills,Nottingham,UK
23,18/07/2022,DD,O2,17.95,,811.55,Other Shopping,Nottingham,UK
24,18/07/2022,BP,SAVE THE CHANGE,2.4,,829.5,Savings,Nottingham,UK
25,18/07/2022,CPT,LNK COOPERATIVE PL,40.0,,831.9,Cash,Plymouth,UK
26,18/07/2022,DEB,COSMIC KITCHEN LIM,75.8,,871.9,Home Improvement,Nottingham,UK
27,18/07/2022,DEB,TESCO STORE 3033,20.0,,947.7,Groceries,Plymouth,UK
28,18/07/2022,DEB,CROWNE PLAZA,10.0,,967.7,Hotels,Plymouth,UK
29,18/07/2022,DEB,EAST MIDS RAILWAY,213.0,,977.7,Travel,Plymouth,UK
30,18/07/2022,DEB,AMZNMktplace,26.99,,1190.7,Amazon,Nottingham,UK
31,18/07/2022,DEB,TESCO STORE 3033,22.1,,1217.69,Groceries,Plymouth,UK
32,18/07/2022,DEB,SumUp  *Taxi first,8.0,,1239.79,Travel,Plymouth,UK
33,15/07/2022,DEB,Amazon.co.uk*ST7ZE,42.01,,1247.79,Amazon,Nottingham,UK
34,15/07/2022,DEB,ASPIRE CAFE,2.7,,1289.8,Dine Out,Nottingham,UK
35,15/07/2022,FPI,WU,,27.0,1292.5,Supplementary Income,Nottingham,UK
36,15/07/2022,BP,SAVE THE CHANGE,1.43,,1265.5,Savings,Nottingham,UK
37,14/07/2022,DEB,UBER   *TRIP,5.66,,1266.93,Travel,Nottingham,UK
38,14/07/2022,DEB,UBER   *TRIP,5.38,,1272.59,Travel,Nottingham,UK
39,14/07/2022,DEB,MEDINA CONTINENTAL,4.53,,1277.97,Dine Out,Nottingham,UK
40,14/07/2022,BP,SAVE THE CHANGE,1.01,,1282.5,Savings,Nottingham,UK
41,13/07/2022,DEB,HPI INSTANT INK UK,4.49,,1283.51,Other Shopping,Nottingham,UK
42,13/07/2022,DEB,CAFE TERRAZZO,3.5,,1288.0,Dine Out,Nottingham,UK
43,13/07/2022,BP,SAVE THE CHANGE,0.08,,1291.5,Savings,Nottingham,UK
44,2022-12-07 00:00:00,FPO,CAPEWELL WINDOW CL,30.0,,1291.58,Home Improvement,Nottingham,UK
45,2022-12-07 00:00:00,DEB,AMZNMktplace,12.99,,1321.58,Amazon,Nottingham,UK
46,2022-12-07 00:00:00,DEB,AMZNMktplace,9.93,,1334.57,Amazon,Nottingham,UK
47,2022-12-07 00:00:00,BP,SAVE THE CHANGE,0.28,,1344.5,Savings,Nottingham,UK
48,2022-11-07 00:00:00,DEB,LIDL GB  NOTTINGHA,47.84,,1344.78,Groceries,Nottingham,UK
49,2022-11-07 00:00:00,DEB,UBER   *TRIP,4.88,,1392.62,Travel,Nottingham,UK
50,2022-11-07 00:00:00,BP,SAVE THE CHANGE,1.16,,1397.5,Savings,Nottingham,UK
51,2022-11-07 00:00:00,DEB,UBER   *TRIP,9.69,,1398.66,Travel,Nottingham,UK
52,2022-11-07 00:00:00,DEB,UBER   *TRIP,7.48,,1408.35,Travel,Nottingham,UK
53,2022-11-07 00:00:00,DEB,Subway 26377 Corne,6.89,,1415.83,Dine Out,Nottingham,UK
54,2022-11-07 00:00:00,DEB,UBER   *TRIP,1.0,,1422.72,Travel,Nottingham,UK
55,2022-08-07 00:00:00,FPI,Zoe Zappa,,325.0,1423.72,Supplementary Income,Nottingham,UK
56,2022-08-07 00:00:00,DEB,DOSA N CHUTNEY,34.78,,1098.72,Dine Out,Nottingham,UK
57,2022-08-07 00:00:00,BGC,UNIV OF NOTTINGHAM,,351.08,1133.5,Travel Reimbursement,Nottingham,UK
58,2022-07-07 00:00:00,BP,SAVE THE CHANGE,0.77,,782.42,Savings,Nottingham,UK
59,2022-06-07 00:00:00,DEB,Hotel on Booking.c,196.24,,783.19,Hotels,Nottingham,UK
60,2022-06-07 00:00:00,DEB,AMZNMktplace,6.99,,979.43,Amazon,Nottingham,UK
61,2022-06-07 00:00:00,BP,SAVE THE CHANGE,0.26,,986.42,Savings,Nottingham,UK
62,2022-05-07 00:00:00,DEB,AMZNMktplace,15.99,,986.68,Amazon,Nottingham,UK
63,2022-05-07 00:00:00,DEB,AMZNMktplace,2.75,,1002.67,Amazon,Nottingham,UK
64,2022-04-07 00:00:00,DEP,CLUB LLOYDS WAIVED,,3.0,1005.42,Supplementary Income,Nottingham,UK
65,2022-04-07 00:00:00,PAY,CLUB LLOYDS FEE,3.0,,1002.42,Bills,Nottingham,UK
66,2022-04-07 00:00:00,FPI,O CONNOR CAROL,,10.0,1005.42,Supplementary Income,Nottingham,UK
67,2022-04-07 00:00:00,BP,SAVE THE CHANGE,0.63,,995.42,Savings,Nottingham,UK
68,2022-04-07 00:00:00,FPO,PAULINA PIPPEN,280.0,,996.05,Safety Deposit Return,,
69,2022-04-07 00:00:00,DEB,AMZNMktplace,27.99,,1276.05,Amazon,Nottingham,UK
70,2022-01-07 00:00:00,,INTEREST (GROSS),,0.56,1304.04,Interest,Nottingham,UK
71,2022-01-07 00:00:00,DEB,TROPICAL SUMMER FE,240.38,,1303.48,Entertainment,Plymouth,UK
72,2022-01-07 00:00:00,DEB,SumUp  *LTP,6.0,,1543.86,Services,Nottingham,UK
73,2022-01-07 00:00:00,DD,BARCLAYS UK MTGES,981.71,,1549.86,Bills,Nottingham,UK
74,2022-01-07 00:00:00,DD,NOTTM CITY COUNC,112.0,,2531.57,Bills,Nottingham,UK
75,2022-01-07 00:00:00,DD,OCTOPUS ENERGY,100.0,,2643.57,Bills,Nottingham,UK
76,2022-01-07 00:00:00,DD,SEVERN TRENT WATER,43.95,,2743.57,Bills,Nottingham,UK
77,2022-01-07 00:00:00,SO,ESAVINGS ACCOUNT,300.0,,2787.52,Savings,Nottingham,UK
78,2022-01-07 00:00:00,BP,SAVE THE CHANGE,0.17,,3087.52,Savings,Nottingham,UK
79,2022-01-07 00:00:00,BGC,UNIV OF NOTTINGHAM,,44.32,3087.69,Supplementary Income,Nottingham,UK
80,30/06/2022,DEB,LIDL GB  NOTTINGHA,8.83,,3043.37,Groceries,Nottingham,UK
81,29/06/2022,DEB,Amazon.co.uk*2Y0SX,229.0,,3052.2,Amazon,Nottingham,UK
82,29/06/2022,FPO,TRADING212UK,1000.0,,3281.2,Investment,Nottingham,UK
83,29/06/2022,DD,THE GYM LTD,19.99,,4281.2,Fitness,Nottingham,UK
84,29/06/2022,BP,SAVE THE CHANGE,0.21,,4301.19,Savings,Nottingham,UK
85,29/06/2022,BGC,UNIV OF NOTTINGHAM,,3748.52,4301.4,Paycheck,Nottingham,UK
86,28/06/2022,DEB,LIDL GB  NOTTINGHA,6.79,,552.88,Groceries,Nottingham,UK
87,28/06/2022,BP,SAVE THE CHANGE,2.0,,559.67,Savings,Nottingham,UK
88,27/06/2022,CPT,LNK TESCO HK R NOT,50.0,,561.67,Cash,nottingham,UK
89,27/06/2022,DEB,LIDL GB NOTTINGHAM,22.09,,611.67,Groceries,Nottingham,UK
90,27/06/2022,DEB,POUNDLAND LTD 1718,14.25,,633.76,Groceries,Nottingham,UK
91,27/06/2022,DEB,UBER   *TRIP,5.78,,648.01,Travel,,
92,27/06/2022,DEB,IZ *LTD GROUP LIMI,4.93,,653.79,Home Improvement,Nottingham,UK
93,27/06/2022,DEB,GREGGS PLC,3.95,,658.72,Dine Out,,
94,27/06/2022,BP,SAVE THE CHANGE,3.26,,662.67,Savings,Nottingham,UK
95,27/06/2022,DEB,HEAVENLY DESSERTS,11.9,,665.93,Dine Out,Nottingham,UK
96,27/06/2022,DEB,LIDL GB  NOTTINGHA,13.06,,677.83,Groceries,Nottingham,UK
97,24/06/2022,DEB,PIE MINISTER,41.2,,690.89,Dine Out,Nottingham,UK
98,24/06/2022,DEB,BELL INN,14.09,,732.09,Dine Out,Nottingham,UK
99,24/06/2022,DEB,CAFE TERRAZZO,3.5,,746.18,Dine Out,Nottingham,UK
100,24/06/2022,DEB,Audible UK,7.99,,749.68,Entertainment,Nottingham,UK
101,24/06/2022,DEB,PIE MINISTER,,8.17,757.67,Supplementary Income,Nottingham,UK
102,23/06/2022,BP,SAVE THE CHANGE,1.26,,749.5,Savings,Nottingham,UK
103,22/06/2022,DEB,DOMINO'S PIZZA,9.99,,750.76,Dine Out,,
104,22/06/2022,DEB,LIDL GB NOTTINGHAM,5.25,,760.75,Groceries,Nottingham,UK
105,22/06/2022,DEB,CAFE TERRAZZO,3.5,,766.0,Dine Out,Nottingham,UK
106,22/06/2022,BP,SAVE THE CHANGE,1.09,,769.5,Savings,Nottingham,UK
107,21/06/2022,DEB,UBER   *TRIP,6.59,,770.59,Travel,,
108,21/06/2022,DEB,NON-GBP TRANS FEE,0.06,,777.18,Others,Nottingham,UK
109,21/06/2022,DEB,ROMA TERMINI SELF,2.32,,777.24,Travel,Roma,Italy
110,21/06/2022,BP,SAVE THE CHANGE,0.92,,779.56,Savings,Nottingham,UK
111,20/06/2022,DEB,DOSA N CHUTNEY,41.2,,780.48,Dine Out,Nottingham,UK
112,20/06/2022,FPO,PAULINA PIPPEN,4.52,,821.68,Food Shopping,,
113,20/06/2022,FPO,MISS D WU,11.0,,826.2,Services,Nottingham,UK
114,20/06/2022,FPO,TRADING212UK,200.0,,837.2,Investment,Nottingham,UK
115,20/06/2022,FPI,SHEILA SMITH,,390.0,1037.2,Supplementary Income,Nottingham,UK
116,20/06/2022,DEB,NON-GBP TRANS FEE,0.44,,647.2,Others,Nottingham,UK
117,20/06/2022,DEB,CHEF EXPRESS S.P.A,14.88,,647.64,Dine Out,Roma,Italy
118,20/06/2022,BP,SAVE THE CHANGE,1.72,,662.52,Savings,Nottingham,UK
119,20/06/2022,DEB,NON-GBP TRANS FEE,0.57,,664.24,Others,Nottingham,UK
120,20/06/2022,DEB,MS* CASASANTASOFIA,19.27,,664.81,Services,Nottingham,UK
121,20/06/2022,DEB,NON-GBP TRANS FEE,0.37,,684.08,Others,Nottingham,UK
122,20/06/2022,DEB,Pizza Forum,12.47,,684.45,Dine Out,Roma,Italy
123,20/06/2022,DEB,AMZNMktplace,23.0,,696.92,Amazon,Nottingham,UK
124,20/06/2022,DEB,NON-GBP TRANS FEE,0.46,,719.92,Others,Nottingham,UK
125,20/06/2022,DEB,BUDDY ITALIAN REST,15.54,,720.38,Dine Out,Roma,Italy
126,17/06/2022,DD,VIRGIN MEDIA PYMTS,56.25,,735.92,Bills,Nottingham,UK
127,17/06/2022,BP,SAVE THE CHANGE,1.26,,792.17,Savings,Nottingham,UK
128,16/06/2022,DEB,NON-GBP TRANS FEE,0.76,,793.43,Others,Nottingham,UK
129,16/06/2022,DEB,UBER   *TRIP,25.57,,794.19,Travel,Roma,Italy
130,16/06/2022,DEB,NON-GBP TRANS FEE,0.57,,819.76,Others,Nottingham,UK
131,16/06/2022,DEB,UBER *TRIP HELP.UB,19.17,,820.33,Travel,Roma,Italy
132,16/06/2022,DD,O2,18.01,,839.5,Other Shopping,Nottingham,UK
133,15/06/2022,BP,SAVE THE CHANGE,0.51,,857.51,Savings,Nottingham,UK
134,14/06/2022,DEB,NON-GBP TRANS FEE,5.11,,858.02,Others,Nottingham,UK
135,14/06/2022,DEB,POSTE ITALIANE,171.0,,863.13,Others,Nottingham,UK
136,14/06/2022,DEB,HPI INSTANT INK UK,4.49,,1034.13,Other Shopping,Nottingham,UK
137,14/06/2022,BP,SAVE THE CHANGE,0.51,,1038.62,Savings,Nottingham,UK
138,13/06/2022,DEB,EAST MIDS RAILWAY,56.7,,1039.13,Travel,Roma,Italy
139,13/06/2022,DEB,WH SMITH,8.79,,1095.83,Other Shopping,Nottingham,UK
140,13/06/2022,BP,SAVE THE CHANGE,4.3,,1104.62,Savings,Nottingham,UK
141,13/06/2022,DEB,ASIANA HYPERMARKET,60.83,,1108.92,Groceries,Nottingham,UK
142,13/06/2022,DEB,LIDL GB NOTTINGHAM,34.12,,1169.75,Groceries,Nottingham,UK
143,13/06/2022,DEB,UBER* TRIP,7.01,,1203.87,Travel,,
144,13/06/2022,CPT,LNK NOTTINGHAM RAI,30.0,,1210.88,Cash,Nottingham,UK
145,13/06/2022,DEB,UBER   *TRIP,7.51,,1240.88,Travel,,
146,13/06/2022,DEB,AMZNMktplace,5.55,,1248.39,Amazon,Nottingham,UK
147,13/06/2022,FPO,MISS D WU,29.0,,1253.94,Services,Nottingham,UK
148,13/06/2022,DEB,DOMINO'S PIZZA - H,,9.99,1282.94,Supplementary Income,Nottingham,UK
149,2022-10-06 00:00:00,FPO,MISS D WU,16.0,,1272.95,Services,Nottingham,UK
150,2022-10-06 00:00:00,DEB,LIDL GB  NOTTINGHA,11.43,,1288.95,Groceries,Nottingham,UK
151,2022-10-06 00:00:00,DEB,CAFE TERRAZZO,2.25,,1300.38,Dine Out,Nottingham,UK
152,2022-09-06 00:00:00,BP,SAVE THE CHANGE,0.97,,1302.63,Savings,Nottingham,UK
153,2022-08-06 00:00:00,DEB,Subway 32610 Midla,13.78,,1303.6,Dine Out,Nottingham,UK
154,2022-08-06 00:00:00,DEB,CAFE TERRAZZO,2.25,,1317.38,Dine Out,Nottingham,UK
155,2022-07-06 00:00:00,BP,SAVE THE CHANGE,2.04,,1319.63,Savings,Nottingham,UK
156,2022-06-06 00:00:00,DEP,CLUB LLOYDS WAIVED,,3.0,1321.67,Amazon,Nottingham,UK
157,2022-06-06 00:00:00,PAY,CLUB LLOYDS FEE,3.0,,1318.67,Bills,Nottingham,UK
158,2022-06-06 00:00:00,DEB,AMZNMktplace,9.99,,1321.67,Supplementary Income,Nottingham,UK
159,2022-06-06 00:00:00,DEB,PRIMARK,38.3,,1331.66,Clothes,,
160,2022-06-06 00:00:00,DEB,BLEND COFFEE HOUSE,18.45,,1369.96,Dine Out,Nottingham,UK
161,2022-06-06 00:00:00,DEB,Murat food centre,13.81,,1388.41,Groceries,Nottingham,UK
162,2022-06-06 00:00:00,DEB,HEAVENLY DESSERTS,4.41,,1402.22,Dine Out,Nottingham,UK
163,2022-06-06 00:00:00,DEB,BLEND COFFEE HOUSE,,3.25,1406.63,Supplementary Income,Nottingham,UK
164,2022-06-06 00:00:00,BP,SAVE THE CHANGE,2.76,,1403.38,Savings,Nottingham,UK
165,2022-06-06 00:00:00,DEB,WHITE ROSE TRADING,29.05,,1406.14,Clothes,,
166,2022-06-06 00:00:00,DEB,PIE MINISTER,23.0,,1435.19,Dine Out,Nottingham,UK
167,2022-06-06 00:00:00,DEB,CINEWORLD NOT CP,19.98,,1458.19,Entertainment,Nottingham,UK
168,2022-06-06 00:00:00,DEB,LIDL GB NOTTINGHAM,16.37,,1478.17,Groceries,Nottingham,UK
169,2022-06-06 00:00:00,DEB,CLOUD9 PURSUITS LT,10.0,,1494.54,Entertainment,Reading,UK
170,2022-06-06 00:00:00,DEB,DOMINO'S PIZZA,9.99,,1504.54,Dine Out,,
171,2022-06-06 00:00:00,DEB,DOMINO'S PIZZA,9.99,,1514.53,Dine Out,,
172,2022-06-06 00:00:00,DEB,DOMINO'S PIZZA,9.99,,1524.52,Dine Out,,
173,2022-06-06 00:00:00,DEB,Amazon.co.uk*2G6K0,6.98,,1534.51,Amazon,Nottingham,UK
174,2022-06-06 00:00:00,DEB,DOMINO'S PIZZA,1.64,,1541.49,Dine Out,,
175,2022-06-06 00:00:00,DEB,LIDL GB  NOTTINGHA,9.0,,1543.13,Groceries,Nottingham,UK
176,2022-01-06 00:00:00,,INTEREST (GROSS),,0.56,1552.13,Interest,Nottingham,UK
177,2022-01-06 00:00:00,DEB,CAFE TERRAZZO,4.25,,1551.57,Dine Out,Nottingham,UK
178,2022-01-06 00:00:00,DD,BARCLAYS UK MTGES,981.71,,1555.82,Bills,Nottingham,UK
179,2022-01-06 00:00:00,DD,NOTTM CITY COUNC,112.0,,2537.53,Bills,Nottingham,UK
180,2022-01-06 00:00:00,DD,OCTOPUS ENERGY,100.0,,2649.53,Bills,Nottingham,UK
181,2022-01-06 00:00:00,DD,SEVERN TRENT WATER,43.97,,2749.53,Bills,Nottingham,UK
182,2022-01-06 00:00:00,SO,ESAVINGS ACCOUNT,300.0,,2793.5,Savings,Nottingham,UK
183,31/05/2022,BP,SAVE THE CHANGE,1.71,,3093.5,Savings,Nottingham,UK
184,30/05/2022,DEB,13th Element,35.5,,3095.21,Dine Out,Nottingham,UK
185,30/05/2022,DEB,ORIENTAL MART HYDR,16.49,,3130.71,Groceries,Nottingham,UK
186,30/05/2022,DEB,IZ *WHITE ROSE TRA,12.0,,3147.2,Clothes,,
187,30/05/2022,DEB,THE GYM LIMITED,10.0,,3159.2,Fitness,Nottingham,UK
188,30/05/2022,DEB,HUI LAU SHAN,9.8,,3169.2,Dine Out,Nottingham,UK
189,30/05/2022,DEB,POUNDLAND LTD 1718,1.5,,3179.0,Groceries,Nottingham,UK
190,30/05/2022,FPO,TRADING212UK,1100.0,,3180.5,Investment,Nottingham,UK
191,30/05/2022,BP,SAVE THE CHANGE,1.89,,4280.5,Savings,Nottingham,UK
192,30/05/2022,BGC,UNIV OF NOTTINGHAM,,3748.92,4282.39,Paycheck,Nottingham,UK
193,30/05/2022,FPO,MISS D WU,26.0,,533.47,Services,Nottingham,UK
194,30/05/2022,DEB,BACHATA SUENO,24.0,,559.47,Entertainment,Nottingham,UK
195,30/05/2022,DEB,LIDL GB  NOTTINGHA,11.58,,583.47,Groceries,Nottingham,UK
196,30/05/2022,DEB,Amazon.co.uk*2G8AO,5.99,,595.05,Amazon,Nottingham,UK
197,27/05/2022,DEB,AMZNMktplace,55.58,,601.04,Amazon,Nottingham,UK
198,27/05/2022,DEB,LIDL GB NOTTINGHAM,31.9,,656.62,Groceries,Nottingham,UK
199,27/05/2022,DEB,UBER   *TRIP,5.06,,688.52,Travel,,
200,27/05/2022,BP,SAVE THE CHANGE,1.03,,693.58,Savings,Nottingham,UK
201,26/05/2022,CPT,LNK TESCO NO RA RD,50.0,,694.61,Cash,Nottingham,UK
202,26/05/2022,DEB,LIDL GB  NOTTINGHA,6.47,,744.61,Groceries,Nottingham,UK
203,26/05/2022,DEB,CAFE TERRAZZO,2.5,,751.08,Dine Out,Nottingham,UK
204,26/05/2022,BP,SAVE THE CHANGE,0.53,,753.58,Savings,Nottingham,UK
205,25/05/2022,DEB,LIDL GB NOTTINGHAM,16.83,,754.11,Groceries,Nottingham,UK
206,25/05/2022,DEB,AMZNMktplace,6.99,,770.94,Amazon,Nottingham,UK
207,25/05/2022,DEB,CAFE TERRAZZO,2.65,,777.93,Dine Out,Nottingham,UK
208,25/05/2022,FPO,TRADING212UK,200.0,,780.58,Investment,Nottingham,UK
209,25/05/2022,FPI,PAULINA PIPPEN,,325.0,980.58,Supplementary Income,Nottingham,UK
210,25/05/2022,BP,SAVE THE CHANGE,0.71,,655.58,Savings,Nottingham,UK
211,24/05/2022,DEB,LIDL GB  NOTTINGHA,5.3,,656.29,Groceries,Nottingham,UK
212,24/05/2022,DEB,Audible UK,7.99,,661.59,Entertainment,Nottingham,UK
213,24/05/2022,BP,SAVE THE CHANGE,0.31,,669.58,Savings,Nottingham,UK
214,23/05/2022,DEB,POUNDLAND LTD 1726,16.0,,669.89,Groceries,Nottingham,UK
215,23/05/2022,DEB,TESCO STORE 2960,15.69,,685.89,Groceries,,
216,23/05/2022,DEB,ALADDINS BIKES,120.0,,701.58,Other Shopping,Nottingham,UK
217,23/05/2022,BP,SAVE THE CHANGE,1.37,,821.58,Savings,Nottingham,UK
218,23/05/2022,DEB,IZ *WHITE ROSE TRA,12.5,,822.95,Clothes,,
219,23/05/2022,DEB,TESCO STORES 6430,2.75,,835.45,Groceries,,
220,23/05/2022,CPT,LNK SAINSBURYS BAN,40.0,,838.2,Cash,,
221,20/05/2022,FPO,MISS D WU,15.0,,878.2,Services,Nottingham,UK
222,20/05/2022,DEB,Kaya Food Centre,6.38,,893.2,Groceries,Nottingham,UK
223,20/05/2022,DEB,ALADDINS BIKES,22.0,,899.58,Other Shopping,Nottingham,UK
224,20/05/2022,FPO,MISS D WU,22.0,,921.58,Services,Nottingham,UK
225,20/05/2022,FPO,TRADING212UK,300.0,,943.58,Investment,Nottingham,UK
226,20/05/2022,FPI,SHEILA SMITH,,380.0,1243.58,Supplementary Income,Nottingham,UK
227,20/05/2022,BP,SAVE THE CHANGE,1.36,,863.58,Savings,Nottingham,UK
228,19/05/2022,DEB,AMZNMktplace,33.02,,864.94,Amazon,Nottingham,UK
229,19/05/2022,DEB,Amazon.co.uk*255RJ,14.99,,897.96,Amazon,Nottingham,UK
230,19/05/2022,DEB,LIDL GB  NOTTINGHA,4.63,,912.95,Groceries,Nottingham,UK
231,19/05/2022,BP,SAVE THE CHANGE,1.32,,917.58,Savings,Nottingham,UK
232,18/05/2022,DEB,ORIENTAL MART HYDR,26.16,,918.9,Groceries,Nottingham,UK
233,18/05/2022,DEB,IZ *WHITE ROSE TRA,10.0,,945.06,Clothes,,
234,18/05/2022,DEB,AMZNMktplace,2.87,,955.06,Amazon,Nottingham,UK
235,18/05/2022,DEB,CAFE TERRAZZO,2.65,,957.93,Dine Out,Nottingham,UK
236,18/05/2022,BP,SAVE THE CHANGE,0.85,,960.58,Savings,Nottingham,UK
237,17/05/2022,DEB,Amazon.co.uk*257UG,12.15,,961.43,Amazon,Nottingham,UK
238,17/05/2022,DD,VIRGIN MEDIA PYMTS,25.5,,973.58,Bills,Nottingham,UK
239,17/05/2022,BP,SAVE THE CHANGE,0.98,,999.08,Savings,Nottingham,UK
240,16/05/2022,DEB,NATIONAL MERCH,30.0,,1000.06,Clothes,,
241,16/05/2022,DEB,HEAVENLY DESSERTS,11.34,,1030.06,Dine Out,Nottingham,UK
242,16/05/2022,DEB,HEAVENLY DESSERTS,4.68,,1041.4,Dine Out,Nottingham,UK
243,16/05/2022,DD,O2,17.95,,1046.08,Other Shopping,Nottingham,UK
244,16/05/2022,BP,SAVE THE CHANGE,3.17,,1064.03,Savings,Nottingham,UK
245,16/05/2022,DEB,SAINSBURYS S/MKTS,35.8,,1067.2,Groceries,,
246,16/05/2022,DEB,DOSA N CHUTNEY,32.2,,1103.0,Dine Out,Nottingham,UK
247,16/05/2022,DEB,Amazon.co.uk*259S0,7.99,,1135.2,Amazon,Nottingham,UK
248,16/05/2022,DEB,LIDL GB  NOTTINGHA,15.84,,1143.19,Groceries,Nottingham,UK
249,16/05/2022,DEB,Amazon.co.uk*255B9,10.99,,1159.03,Amazon,Nottingham,UK
250,16/05/2022,DEB,ALADDINS BIKES,6.0,,1170.02,Other Shopping,Nottingham,UK
251,13/05/2022,DEB,HPI INSTANT INK UK,4.49,,1176.02,Other Shopping,,
252,13/05/2022,DEB,Subway 32610 Midla,11.48,,1180.51,Dine Out,Nottingham,UK
253,13/05/2022,DEB,LIDL GB NOTTINGHAM,7.54,,1191.99,Groceries,Nottingham,UK
254,13/05/2022,DEB,DERBY MED CAFE,3.5,,1199.53,Dine Out,Derby,UK
255,13/05/2022,FPO,TRADING212UK,500.0,,1203.03,Investment,Nottingham,UK
256,13/05/2022,TFR,R LAWRENCE,,300.0,1703.03,Supplementary Income,Nottingham,UK
257,2022-12-05 00:00:00,BP,SAVE THE CHANGE,0.5,,1403.03,Savings,Nottingham,UK
258,2022-12-05 00:00:00,BGC,NCC TRADE CRED NEW,,150.0,1403.53,Supplementary Income,Nottingham,UK
259,2022-11-05 00:00:00,DEB,UBER   *TRIP,4.0,,1253.53,Travel,,
260,2022-11-05 00:00:00,DEB,DERBY MED CAFE,3.5,,1257.53,Dine Out,Derby,UK
261,2022-11-05 00:00:00,BP,SAVE THE CHANGE,0.59,,1261.03,Savings,Nottingham,UK
262,2022-10-05 00:00:00,FPO,MISS D WU,13.0,,1261.62,Services,Nottingham,UK
263,2022-10-05 00:00:00,DEB,RAJAH FOOD STORE L,20.41,,1274.62,Groceries,Nottingham,UK
264,2022-09-05 00:00:00,BP,SAVE THE CHANGE,2.25,,1295.03,Savings,Nottingham,UK
265,2022-09-05 00:00:00,DEB,MASALA JUNCTION,47.98,,1297.28,Dine Out,Nottingham,UK
266,2022-09-05 00:00:00,DEB,LIDL GB  NOTTINGHA,14.01,,1345.26,Groceries,Nottingham,UK
267,2022-09-05 00:00:00,DEB,LIDL GB  NOTTINGHA,5.85,,1359.27,Groceries,Nottingham,UK
268,2022-09-05 00:00:00,FPI,SHEILA SMITH,,50.0,1365.12,Supplementary Income,Nottingham,UK
269,2022-06-05 00:00:00,DEB,HEAVENLY DESSERTS,10.26,,1315.12,Dine Out,Nottingham,UK
270,2022-06-05 00:00:00,DEB,CAFE TERRAZZO,6.0,,1325.38,Dine Out,Nottingham,UK
271,2022-06-05 00:00:00,DEB,CAFE TERRAZZO,2.65,,1331.38,Dine Out,Nottingham,UK
272,2022-06-05 00:00:00,BP,SAVE THE CHANGE,1.46,,1334.03,Savings,Nottingham,UK
273,2022-05-05 00:00:00,DEB,AMZN Mktp US*1363Y,22.7,,1335.49,Amazon,Nottingham,UK
274,2022-05-05 00:00:00,DEB,AMZNMktplace,43.77,,1358.19,Amazon,Nottingham,UK
275,2022-05-05 00:00:00,DEB,LIDL GB  NOTTINGHA,8.57,,1401.96,Groceries,Nottingham,UK
276,2022-05-05 00:00:00,DEB,DERBY MED CAFE,3.5,,1410.53,Dine Out,Derby,UK
277,2022-05-05 00:00:00,DD,OCTOPUS ENERGY,100.0,,1414.03,Bills,Nottingham,UK
278,2022-04-05 00:00:00,DEP,CLUB LLOYDS WAIVED,,3.0,1514.03,Supplementary Income,Nottingham,UK
279,2022-04-05 00:00:00,PAY,CLUB LLOYDS FEE,3.0,,1511.03,Bills,Nottingham,UK
280,2022-04-05 00:00:00,DD,NOTTM CITY COUNC,112.0,,1514.03,Bills,Nottingham,UK
281,2022-04-05 00:00:00,BP,SAVE THE CHANGE,0.42,,1626.03,Savings,Nottingham,UK
282,2022-03-05 00:00:00,,INTEREST (GROSS),,0.57,1626.45,Interest,Nottingham,UK
283,2022-03-05 00:00:00,FPO,MISS D WU,23.0,,1625.88,Services,Nottingham,UK
284,2022-03-05 00:00:00,DEB,LIDL GB  NOTTINGHA,12.58,,1648.88,Groceries,Nottingham,UK
285,2022-03-05 00:00:00,FPO,MISS D WU,21.0,,1661.46,Services,Nottingham,UK
286,2022-03-05 00:00:00,TFR,R LAWRENCE,,230.66,1682.46,Supplementary Income,Nottingham,UK
287,2022-03-05 00:00:00,DD,BARCLAYS UK MTGES,981.71,,1451.8,Bills,Nottingham,UK
288,2022-03-05 00:00:00,DD,SEVERN TRENT WATER,41.89,,2433.51,Bills,Nottingham,UK
289,2022-03-05 00:00:00,SO,ESAVINGS ACCOUNT,300.0,,2475.4,Savings,Nottingham,UK
290,2022-03-05 00:00:00,BP,SAVE THE CHANGE,3.99,,2775.4,Savings,Nottingham,UK
291,2022-03-05 00:00:00,DEB,ALDI,37.27,,2779.39,Groceries,,
292,2022-03-05 00:00:00,DEB,AMZNMktplace,28.65,,2816.66,Amazon,Nottingham,UK
293,2022-03-05 00:00:00,DEB,ORIENTAL MART HYDR,12.8,,2845.31,Groceries,Nottingham,UK
294,2022-03-05 00:00:00,DEB,STARBUCKS,8.3,,2858.11,Dine Out,,
295,2022-03-05 00:00:00,DEB,KFC NOTTINGHAM,1.49,,2866.41,Dine Out,Nottingham,UK
296,2022-03-05 00:00:00,DEB,SQ *NOTTINGHAM BAC,10.0,,2867.9,Entertainment,Nottingham,UK
297,2022-03-05 00:00:00,DEB,CONFETTI CONSTELLA,5.5,,2877.9,Home Improvement,Nottingham,UK
298,2022-03-05 00:00:00,DEB,CONFETTI CONSTELLA,3.5,,2883.4,Home Improvement,Nottingham,UK
299,29/04/2022,DEB,DERBY MED CAFE,3.5,,2886.9,Dine Out,Derby,UK
300,28/04/2022,FPO,TRADING212UK,1100.0,,2890.4,Investment,Nottingham,UK
301,28/04/2022,BP,SAVE THE CHANGE,2.44,,3990.4,Savings,Nottingham,UK
302,28/04/2022,BGC,UNIV OF NOTTINGHAM,,3748.93,3992.84,Paycheck,Nottingham,UK
303,27/04/2022,DEB,Amazon.co.uk*2P60A,18.02,,243.91,Amazon,Nottingham,UK
304,27/04/2022,DEB,DOSA N CHUTNEY,13.4,,261.93,Dine Out,Nottingham,UK
305,27/04/2022,DEB,LIDL GB NOTTINGHAM,8.65,,275.33,Groceries,Nottingham,UK
306,27/04/2022,DEB,AMZNMktplace,4.99,,283.98,Amazon,Nottingham,UK
307,27/04/2022,DEB,DERBY MED CAFE,3.5,,288.97,Dine Out,Derby,UK
308,27/04/2022,BP,SAVE THE CHANGE,0.99,,292.47,Savings,Nottingham,UK
309,26/04/2022,DEB,AMZNMktplace,41.01,,293.46,Amazon,Nottingham,UK
310,26/04/2022,BP,SAVE THE CHANGE,0.7,,334.47,Savings,Nottingham,UK
311,25/04/2022,DEB,DOSA N CHUTNEY,14.8,,335.17,Dine Out,Nottingham,UK
312,25/04/2022,DEB,TESCO STORES 5653,10.5,,349.97,Groceries,,
313,25/04/2022,BP,SAVE THE CHANGE,2.74,,360.47,Savings,Nottingham,UK
314,25/04/2022,DEB,WORTH THE WEIGHT L,27.0,,363.21,Clothes,,
315,25/04/2022,DEB,HEAVENLY DESSERTS,15.35,,390.21,Dine Out,Nottingham,UK
316,25/04/2022,DEB,Audible UK,7.99,,405.56,Entertainment,Nottingham,UK
317,25/04/2022,FPO,MISS D WU,13.0,,413.55,Services,Nottingham,UK
318,25/04/2022,DEB,TESCO STORE 2960,31.82,,426.55,Groceries,,
319,25/04/2022,DEB,ORIENTAL MART HYDR,16.69,,458.37,Groceries,Nottingham,UK
320,25/04/2022,CPT,LNK TESCO LONG ROW,40.0,,475.06,Cash,Nottingham,UK
321,25/04/2022,FPO,TAMBA TAM,13.0,,515.06,Services,Nottingham,UK
322,22/04/2022,DEB,AMZNMktplace,22.89,,528.06,Amazon,Nottingham,UK
323,22/04/2022,DEB,Amazon.co.uk*2P3K6,20.24,,550.95,Amazon,Nottingham,UK
324,22/04/2022,DEB,LIDL GB  NOTTINGHA,11.28,,571.19,Groceries,Nottingham,UK
325,21/04/2022,FPO,TRADING212UK,200.0,,582.47,Investment,Nottingham,UK
326,21/04/2022,FPI,PAULINA PIPPEN,,320.0,782.47,Supplementary Income,Nottingham,UK
327,21/04/2022,BP,SAVE THE CHANGE,0.34,,462.47,Savings,Nottingham,UK
328,20/04/2022,DEB,CINEWORLD NOT CP,19.98,,462.81,Entertainment,Nottingham,UK
329,20/04/2022,DEB,HEAVENLY DESSERTS,4.68,,482.79,Dine Out,Nottingham,UK
330,20/04/2022,FPO,TRADING212UK,206.96,,487.47,Investment,Nottingham,UK
331,20/04/2022,FPI,SHEILA SMITH,,380.0,694.43,Supplementary Income,Nottingham,UK
332,20/04/2022,DD,O2,17.95,,314.43,Other Shopping,Nottingham,UK
333,20/04/2022,BP,SAVE THE CHANGE,2.24,,332.38,Savings,Nottingham,UK
334,19/04/2022,DEB,J D SPORTS PLC,85.0,,334.62,Other Shopping,,
335,19/04/2022,DEB,LAS IGUANAS,35.06,,419.62,Dine Out,Nottingham,UK
336,19/04/2022,DEB,AMZNMktplace,23.95,,454.68,Amazon,Nottingham,UK
337,19/04/2022,DEB,Elenas Patisserie,15.25,,478.63,Services,Nottingham,UK
338,19/04/2022,DEB,TESCO STORES 5653,11.5,,493.88,Groceries,,
339,19/04/2022,DD,VIRGIN MEDIA PYMTS,25.5,,505.38,Bills,Nottingham,UK
340,19/04/2022,BP,SAVE THE CHANGE,2.85,,530.88,Savings,Nottingham,UK
341,19/04/2022,DEB,THE NED LUDD,6.95,,533.73,Dine Out,Nottingham,UK
342,19/04/2022,DEB,HEAVENLY DESSERTS,6.39,,540.68,Dine Out,Nottingham,UK
343,19/04/2022,DEB,AMZNMktplace,46.99,,547.07,Amazon,Nottingham,UK
344,19/04/2022,DEB,LIDL GB  NOTTINGHA,23.79,,594.06,Groceries,Nottingham,UK
345,19/04/2022,DEB,GetYourGuide UK Lt,,4.5,617.85,Supplementary Income,Nottingham,UK
346,19/04/2022,DEB,SUTTON COLDFIELD A,8.4,,613.35,Travel,Birmingham,UK
347,19/04/2022,DEB,SUTTON COLDFIELD A,5.3,,621.75,Travel,Birmingham,UK
348,19/04/2022,DEB,IZ *WHITE ROSE TRA,11.85,,627.05,Clothes,,
349,19/04/2022,DEB,AMZNMktplace,9.99,,638.9,Amazon,Nottingham,UK
350,14/04/2022,DEB,HPI INSTANT INK UK,4.49,,648.89,Other Shopping,,
351,14/04/2022,CPT,LNK SAINSBURYS BAN,40.0,,653.38,Cash,,
352,14/04/2022,BP,SAVE THE CHANGE,0.88,,693.38,Savings,Nottingham,UK
353,13/04/2022,DEB,LIDL GB NOTTINGHAM,66.13,,694.26,Groceries,Nottingham,UK
354,13/04/2022,DEB,UBER   *TRIP,4.99,,760.39,Travel,,
355,13/04/2022,BP,SAVE THE CHANGE,0.01,,765.38,Savings,Nottingham,UK
356,2022-12-04 00:00:00,DEB,AMZNMktplace,9.99,,765.39,Amazon,Nottingham,UK
357,2022-12-04 00:00:00,BP,SAVE THE CHANGE,0.1,,775.38,Savings,Nottingham,UK
358,2022-11-04 00:00:00,DEB,AMZNMktplace,16.97,,775.48,Amazon,Nottingham,UK
359,2022-11-04 00:00:00,DEB,UBER   *TRIP,6.93,,792.45,Travel,,
360,2022-11-04 00:00:00,BP,SAVE THE CHANGE,4.88,,799.38,Savings,Nottingham,UK
361,2022-11-04 00:00:00,DEB,STARBUCKS,13.1,,804.26,Dine Out,,
362,2022-11-04 00:00:00,DEB,KELLYS CELLARS,7.8,,817.36,Dine Out,Belfast,UK
363,2022-11-04 00:00:00,DEB,ARRIVA MERSEYSIDE,4.6,,825.16,Travel,,
364,2022-11-04 00:00:00,DEB,STARBUCKS,3.75,,829.76,Dine Out,,
365,2022-11-04 00:00:00,CPT,LNK TESCO M M WA N,40.0,,833.51,Cash,,
366,2022-11-04 00:00:00,DEB,JUMON,56.1,,873.51,Dine Out,Belfast,UK
367,2022-11-04 00:00:00,DEB,UBER   *TRIP,7.07,,929.61,Travel,,
368,2022-08-04 00:00:00,DEB,DARCYS RESTAURANT,39.5,,936.68,Dine Out,Belfast,UK
369,2022-08-04 00:00:00,DEB,THE GIANTS BARN CA,5.2,,976.18,Dine Out,Bushmills,UK
370,2022-08-04 00:00:00,BP,SAVE THE CHANGE,1.81,,981.38,Savings,Nottingham,UK
371,2022-07-04 00:00:00,FPO,MISS D WU,40.0,,983.19,Services,Nottingham,UK
372,2022-07-04 00:00:00,DEB,AZZURRI RESTAURANT,24.9,,1023.19,Dine Out,Newcastle upon Tyne,UK
373,2022-07-04 00:00:00,DEB,Subway 69392 Belfa,9.98,,1048.09,Dine Out,Belfast ,UK
374,2022-07-04 00:00:00,DEB,LIDL NI LTD,7.29,,1058.07,Groceries,Nottingham,UK
375,2022-07-04 00:00:00,DEB,UBER   *TRIP,6.02,,1065.36,Travel,,
376,2022-07-04 00:00:00,BP,SAVE THE CHANGE,2.0,,1071.38,Savings,Nottingham,UK
377,2022-06-04 00:00:00,DEB,GetYourGuide UK Lt,43.0,,1073.38,Travel,,
378,2022-06-04 00:00:00,DEB,GetYourGuide UK Lt,36.0,,1116.38,Travel,,
379,2022-06-04 00:00:00,DEB,LIDL NI LTD,37.09,,1152.38,Groceries,Nottingham,UK
380,2022-06-04 00:00:00,DEB,VISIT BELFAST,23.0,,1189.47,Travel,Belfast,UK
381,2022-06-04 00:00:00,DEB,BURGER KING,18.68,,1212.47,Dine Out,,
382,2022-06-04 00:00:00,DEB,LITTLE WING PIZZER,15.8,,1231.15,Dine Out,Belfast,UK
383,2022-06-04 00:00:00,DEB,UBER   *TRIP,6.83,,1246.95,Travel,,
384,2022-06-04 00:00:00,DEB,ARRIVA MERSEYSIDE,4.6,,1253.78,Travel,,
385,2022-06-04 00:00:00,BP,SAVE THE CHANGE,1.38,,1258.38,Savings,Nottingham,UK
386,2022-05-04 00:00:00,DEB,LIDL GB  NOTTINGHA,16.13,,1259.76,Groceries,Nottingham,UK
387,2022-05-04 00:00:00,DEB,UBER   *TRIP,6.49,,1275.89,Travel,,
388,2022-05-04 00:00:00,BP,SAVE THE CHANGE,0.98,,1282.38,Savings,Nottingham,UK
389,2022-04-04 00:00:00,DEP,CLUB LLOYDS WAIVED,,3.0,1283.36,Supplementary Income,Nottingham,UK
390,2022-04-04 00:00:00,PAY,CLUB LLOYDS FEE,3.0,,1280.36,Bills,Nottingham,UK
391,2022-04-04 00:00:00,DEB,ZTL*White Rose Tra,18.0,,1283.36,Clothes,Nottingham,UK
392,2022-04-04 00:00:00,DEB,SLIM CHICKENS NOTT,8.0,,1301.36,Groceries,Nottingham,UK
393,2022-04-04 00:00:00,DEB,HEAVENLY DESSERTS,7.02,,1309.36,Dine Out,Nottingham,UK
394,2022-04-04 00:00:00,CPT,LNK TESCO HK R NOT,40.0,,1316.38,Cash,nottingham,UK
395,2022-04-04 00:00:00,BP,SAVE THE CHANGE,2.12,,1356.38,Savings,Nottingham,UK
396,2022-04-04 00:00:00,DEB,200 DEGREES,10.2,,1358.5,Dine Out,Nottingham,UK
397,2022-04-04 00:00:00,DEB,THE BREWHOUSE ART,4.0,,1368.7,Others,Nottingham,UK
398,2022-04-04 00:00:00,DEB,EASTMIDLANDSCOM,50.0,,1372.7,Travel,,
399,2022-04-04 00:00:00,DEB,LIDL GB  NOTTINGHA,13.34,,1422.7,Groceries,Nottingham,UK
400,2022-04-04 00:00:00,DEB,ATRIUM JUBILEE 1,4.45,,1436.04,Dine Out,Nottingham,UK
401,2022-04-04 00:00:00,FPO,MISS D WU,44.0,,1440.49,Services,Nottingham,UK
402,2022-04-04 00:00:00,TFR,R LAWRENCE  02APR22,,126.0,1484.49,Supplementary Income,Nottingham,UK
403,2022-04-04 00:00:00,FPO,MISS D WU,34.0,,1358.49,Services,Nottingham,UK
404,2022-01-04 00:00:00,,INTEREST (GROSS),,0.49,1392.49,Interest,Nottingham,UK
405,2022-01-04 00:00:00,DEB,Subway 32610 Midla,6.89,,1392.0,Dine Out,Nottingham,UK
406,2022-01-04 00:00:00,FPO,MISS D WU,20.0,,1398.89,Services,Nottingham,UK
407,2022-01-04 00:00:00,DD,BARCLAYS UK MTGES,981.71,,1418.89,Bills,Nottingham,UK
408,2022-01-04 00:00:00,DD,NOTTM CITY COUNC,106.25,,2400.6,Bills,Nottingham,UK
409,2022-01-04 00:00:00,DD,OCTOPUS ENERGY,90.0,,2506.85,Bills,Nottingham,UK
410,2022-01-04 00:00:00,DD,SEVERN TRENT WATER,41.89,,2596.85,Bills,Nottingham,UK
411,2022-01-04 00:00:00,SO,ESAVINGS ACCOUNT,300.0,,2638.74,Savings,Nottingham,UK
412,2022-01-04 00:00:00,BP,SAVE THE CHANGE,1.27,,2938.74,Savings,Nottingham,UK
413,31/03/2022,DEB,DELIVEROO,10.48,,2940.01,Dine Out,,
414,31/03/2022,DEB,ATRIUM JUBILEE 1,4.25,,2950.49,Dine Out,Nottingham,UK
415,31/03/2022,FPO,TRADING212UK,1000.0,,2954.74,Investment,Nottingham,UK
416,31/03/2022,BP,SAVE THE CHANGE,1.31,,3954.74,Savings,Nottingham,UK
417,30/03/2022,DEB,STARBUCKS,11.85,,3956.05,Dine Out,,
418,30/03/2022,DEB,Subway 32610 Midla,6.19,,3967.9,Dine Out,Nottingham,UK
419,30/03/2022,DEB,ATRIUM JUBILEE 1,2.65,,3974.09,Dine Out,Nottingham,UK
420,30/03/2022,BGC,UNIV OF NOTTINGHAM,,3801.43,3976.74,Paycheck,Nottingham,UK
421,29/03/2022,BP,SAVE THE CHANGE,0.45,,175.31,Savings,Nottingham,UK
422,28/03/2022,DEB,UBER   *TRIP,6.55,,175.76,Travel,,
423,28/03/2022,BP,SAVE THE CHANGE,4.38,,182.31,Savings,Nottingham,UK
424,28/03/2022,DEB,LIDL GB NOTTINGHAM,47.83,,186.69,Groceries,Nottingham,UK
425,28/03/2022,DEB,ORIENTAL MART HYDR,20.28,,234.52,Groceries,Nottingham,UK
426,28/03/2022,DEB,POUNDLAND LTD 1726,13.0,,254.8,Groceries,Nottingham,UK
427,28/03/2022,DEB,AMZNMktplace,5.99,,267.8,Amazon,Nottingham,UK
428,28/03/2022,FPO,MISS D WU,20.0,,273.79,Services,Nottingham,UK
429,28/03/2022,FPO,TAMBA TAM,10.0,,293.79,Services,Nottingham,UK
430,28/03/2022,DEB,KFC NOTTINGHAM,1.49,,303.79,Dine Out,Nottingham,UK
431,28/03/2022,DEB,SQ *NOTTINGHAM BAC,12.0,,305.28,Entertainment,Nottingham,UK
432,28/03/2022,DEB,CONFETTI CONSTELLA,7.1,,317.28,Home Improvement,Nottingham,UK
433,28/03/2022,DEB,CONFETTI CONSTELLA,6.2,,324.38,Home Improvement,Nottingham,UK
434,25/03/2022,DEB,AIRBNB * HMREJB2DY,376.55,,330.58,Hotels,,
435,25/03/2022,DEB,Subway 32610 Midla,10.18,,707.13,Dine Out,Nottingham,UK
436,25/03/2022,FPO,TRADING212UK,200.0,,717.31,Investment,Nottingham,UK
437,25/03/2022,DD,TALKTALK LIMITED,29.95,,917.31,Bills,Nottingham,UK
438,25/03/2022,BP,SAVE THE CHANGE,0.1,,947.26,Savings,Nottingham,UK
439,24/03/2022,DEB,EASYJET   000K38,327.92,,947.36,Travel,,
440,24/03/2022,DEB,AMZNMktplace,9.99,,1275.28,Amazon,Nottingham,UK
441,24/03/2022,DEB,Audible UK,7.99,,1285.27,Entertainment,Nottingham,UK
442,24/03/2022,FPI,PAULINA PIPPEN,,320.0,1293.26,Supplementary Income,Nottingham,UK
443,24/03/2022,BP,SAVE THE CHANGE,0.89,,973.26,Savings,Nottingham,UK
444,23/03/2022,TFR,R LAWRENCE,,300.0,974.15,Supplementary Income,Nottingham,UK
445,23/03/2022,DEB,AMZNMktplace,6.49,,674.15,Amazon,Nottingham,UK
446,23/03/2022,DEB,ATRIUM JUBILEE 1,2.65,,680.64,Dine Out,Nottingham,UK
447,23/03/2022,DEB,LIDL GB NOTTINGHAM,1.97,,683.29,Groceries,Nottingham,UK
448,23/03/2022,BP,SAVE THE CHANGE,0.5,,685.26,Savings,Nottingham,UK
449,23/03/2022,BGC,GOOGLE IRELAND,,63.27,685.76,Supplementary Income,Nottingham,UK
450,22/03/2022,FPO,TRADING212UK,200.0,,622.49,Investment,Nottingham,UK
451,22/03/2022,FPI,SHEILA SMITH,,380.0,822.49,Supplementary Income,Nottingham,UK
452,22/03/2022,CPT,LNK TESCO NO RA RD,40.0,,442.49,Cash,Nottingham,UK
453,22/03/2022,DEB,PRIMARK,13.5,,482.49,Clothes,,
454,22/03/2022,BP,SAVE THE CHANGE,1.5,,495.99,Savings,Nottingham,UK
455,21/03/2022,DEB,TESCO STORES 6430,7.55,,497.49,Groceries,,
456,21/03/2022,DEB,STARBUCKS,6.45,,505.04,Dine Out,,
457,21/03/2022,DEB,SPORTSDIRECT 195,4.5,,511.49,Other Shopping,,
458,21/03/2022,BP,SAVE THE CHANGE,2.54,,515.99,Savings,Nottingham,UK
459,21/03/2022,DEB,LIDL GB  NOTTINGHA,28.13,,518.53,Groceries,Nottingham,UK
460,21/03/2022,FPO,MISS D WU,30.0,,546.66,Services,Nottingham,UK
461,18/03/2022,DEB,HPI INSTANT INK UK,4.49,,576.66,Other Shopping,,
462,18/03/2022,DEB,SUMUP  *LTP,15.0,,581.15,Services,Nottingham,UK
463,18/03/2022,DEB,Subway 32610 Midla,6.19,,596.15,Dine Out,Nottingham,UK
464,18/03/2022,DEB,ATRIUM JUBILEE 1,2.65,,602.34,Dine Out,Nottingham,UK
465,17/03/2022,DD,VIRGIN MEDIA PYMTS,25.5,,604.99,Bills,Nottingham,UK
466,17/03/2022,BP,SAVE THE CHANGE,1.85,,630.49,Savings,Nottingham,UK
467,16/03/2022,DEB,LIDL GB NOTTINGHAM,16.1,,632.34,Groceries,Nottingham,UK
468,16/03/2022,DEB,ATRIUM JUBILEE 1,13.5,,648.44,Dine Out,Nottingham,UK
469,16/03/2022,DEB,Amazon.co.uk*2159U,5.84,,661.94,Amazon,Nottingham,UK
470,16/03/2022,DEB,UBER   *TRIP,4.71,,667.78,Travel,,
471,16/03/2022,FPO,MISS D WU,6.35,,672.49,Services,Nottingham,UK
472,16/03/2022,DD,O2,17.31,,678.84,Other Shopping,Nottingham,UK
473,15/03/2022,BP,SAVE THE CHANGE,2.0,,696.15,Savings,Nottingham,UK
474,14/03/2022,FPO,TAMBA TAM,7.0,,698.15,Services,Nottingham,UK
475,14/03/2022,DEB,LIDL GB NOTTINGHAM,53.54,,705.15,Groceries,Nottingham,UK
476,14/03/2022,DEB,UBER   *TRIP,5.33,,758.69,Travel,,
477,14/03/2022,DEB,UBER   *TRIP,19.33,,764.02,Travel,,
478,14/03/2022,DEB,UBER   *TRIP,17.8,,783.35,Travel,,
479,14/03/2022,BP,SAVE THE CHANGE,2.15,,801.15,Savings,Nottingham,UK
480,14/03/2022,DEB,RAMSDALE PARK GC,13.0,,803.3,Entertainment,Nottingham,UK
481,14/03/2022,DEB,RAMSDALE PARK GC,13.0,,816.3,Entertainment,Nottingham,UK
482,14/03/2022,DEB,Subway 30392 Lento,8.58,,829.3,Dine Out,Nottingham,UK
483,14/03/2022,DEB,RAMSDALE PARK GC,7.85,,837.88,Entertainment,Nottingham,UK
484,14/03/2022,CPT,LNK COOPERATIVE LE,50.0,,845.73,Cash,Leicester,UK
485,14/03/2022,DEB,Subway 26377 Corne,7.28,,895.73,Dine Out,Nottingham,UK
486,2022-11-03 00:00:00,DEB,SUMUP  *LTP,15.0,,903.01,Services,Nottingham,UK
487,2022-11-03 00:00:00,DEB,Subway 32610 Midla,6.89,,918.01,Dine Out,Nottingham,UK
488,2022-11-03 00:00:00,DEB,ATRIUM JUBILEE 1,4.25,,924.9,Dine Out,Nottingham,UK
489,2022-10-03 00:00:00,FPO,TAMBA TAM,10.0,,929.15,Services,Nottingham,UK
490,2022-10-03 00:00:00,BP,SAVE THE CHANGE,0.76,,939.15,Savings,Nottingham,UK
491,2022-09-03 00:00:00,DEB,Amazon Prime*2X250,79.0,,939.91,Amazon,Nottingham,UK
492,2022-09-03 00:00:00,DEB,Amazon.co.uk*2X7YI,13.99,,1018.91,Amazon,Nottingham,UK
493,2022-09-03 00:00:00,DEB,Amazon.co.uk*2X6A1,6.0,,1032.9,Amazon,Nottingham,UK
494,2022-09-03 00:00:00,DEB,ATRIUM JUBILEE 1,4.25,,1038.9,Dine Out,Nottingham,UK
495,2022-09-03 00:00:00,BP,SAVE THE CHANGE,0.26,,1043.15,Savings,Nottingham,UK
496,2022-08-03 00:00:00,DEB,LIDL GB  NOTTINGHA,20.76,,1043.41,Groceries,Nottingham,UK
497,2022-08-03 00:00:00,DEB,AMZNMktplace,14.99,,1064.17,Amazon,Nottingham,UK
498,2022-08-03 00:00:00,DEB,AMZNMktplace,9.99,,1079.16,Amazon,Nottingham,UK
499,2022-08-03 00:00:00,BP,SAVE THE CHANGE,0.12,,1089.15,Savings,Nottingham,UK
500,2022-07-03 00:00:00,DEB,CINEWORLD,32.88,,1089.27,Entertainment,Nottingham,UK
501,2022-07-03 00:00:00,BP,SAVE THE CHANGE,4.52,,1122.15,Savings,Nottingham,UK
502,2022-07-03 00:00:00,DEB,ORIENTAL MART HYDR,54.52,,1126.67,Groceries,Nottingham,UK
503,2022-07-03 00:00:00,DEB,LIDL GB NOTTINGHAM,48.3,,1181.19,Groceries,Nottingham,UK
504,2022-07-03 00:00:00,DEB,Tasnack,25.7,,1229.49,Dine Out,Nottingham,UK
505,2022-07-03 00:00:00,DEB,NOTTINGHAM WATCH R,10.0,,1255.19,Others,Nottingham,UK
506,2022-07-03 00:00:00,DEB,UBER* TRIP,5.16,,1265.19,Travel,,
507,2022-07-03 00:00:00,DEB,HEAVENLY DESSERTS,6.2,,1270.35,Dine Out,Nottingham,UK
508,2022-07-03 00:00:00,CPT,LOYD LOYD LOWER PA,40.0,,1276.55,Cash,Nottingham,UK
509,2022-04-03 00:00:00,DEB,SUMUP  *LTP,24.0,,1316.55,Services,Nottingham,UK
510,2022-04-03 00:00:00,DEB,Subway 32610 Midla,6.89,,1340.55,Dine Out,Nottingham,UK
511,2022-04-03 00:00:00,DEB,ATRIUM JUBILEE 1,4.25,,1347.44,Dine Out,Nottingham,UK
512,2022-04-03 00:00:00,DEB,LIDL GB NOTTINGHAM,2.46,,1351.69,Groceries,Nottingham,UK
513,2022-04-03 00:00:00,BP,SAVE THE CHANGE,0.75,,1354.15,Savings,Nottingham,UK
514,2022-03-03 00:00:00,DEB,Amazon.co.uk*2X4DF,7.0,,1354.9,Amazon,Nottingham,UK
515,2022-03-03 00:00:00,DEB,ATRIUM JUBILEE 1,4.25,,1361.9,Dine Out,Nottingham,UK
516,2022-03-03 00:00:00,BP,SAVE THE CHANGE,0.86,,1366.15,Savings,Nottingham,UK
517,2022-02-03 00:00:00,DEP,CLUB LLOYDS WAIVED,,3.0,1367.01,Supplementary Income,Nottingham,UK
518,2022-02-03 00:00:00,PAY,CLUB LLOYDS FEE,3.0,,1364.01,Bills,Nottingham,UK
519,2022-02-03 00:00:00,DEB,TESCO STORES 5653,16.6,,1367.01,Groceries,,
520,2022-02-03 00:00:00,DEB,Subway 32610 Midla,6.89,,1383.61,Dine Out,Nottingham,UK
521,2022-02-03 00:00:00,DEB,ATRIUM JUBILEE 1,2.65,,1390.5,Dine Out,Nottingham,UK
522,2022-02-03 00:00:00,TFR,R LAWRENCE,,27.69,1393.15,Supplementary Income,Nottingham,UK
523,2022-02-03 00:00:00,FPO,TAMBA TAM,7.0,,1365.46,Services,Nottingham,UK
524,2022-02-03 00:00:00,FPO,MISS D WU,10.0,,1372.46,Services,Nottingham,UK
525,2022-02-03 00:00:00,BP,SAVE THE CHANGE,0.95,,1382.46,Savings,Nottingham,UK
526,2022-01-03 00:00:00,,INTEREST (GROSS),,0.47,1383.41,Interest,Nottingham,UK
527,2022-01-03 00:00:00,DEB,SAINSBURYS S/MKTS,33.05,,1382.94,Groceries,,
528,2022-01-03 00:00:00,DD,BARCLAYS UK MTGES,981.71,,1415.99,Bills,Nottingham,UK
529,2022-01-03 00:00:00,DD,NOTTM CITY COUNC,157.0,,2397.7,Bills,Nottingham,UK
530,2022-01-03 00:00:00,DD,OCTOPUS ENERGY,90.0,,2554.7,Bills,Nottingham,UK
531,2022-01-03 00:00:00,DD,SEVERN TRENT WATER,41.89,,2644.7,Bills,Nottingham,UK
532,2022-01-03 00:00:00,SO,ESAVINGS ACCOUNT,300.0,,2686.59,Savings,Nottingham,UK
533,2022-01-03 00:00:00,BP,SAVE THE CHANGE,1.08,,2986.59,Savings,Nottingham,UK
534,28/02/2022,DEB,UBER   *TRIP,7.11,,2987.67,Travel,,
535,28/02/2022,DEB,UBER   *TRIP,6.81,,2994.78,Travel,,
536,28/02/2022,BP,SAVE THE CHANGE,2.47,,3001.59,Savings,Nottingham,UK
537,28/02/2022,DEB,BURGER KING,13.57,,3004.06,Dine Out,,
538,28/02/2022,DEB,LIDL GB  NOTTINGHA,10.11,,3017.63,Groceries,Nottingham,UK
539,28/02/2022,DEB,SQ *NOTTINGHAM BAC,12.0,,3027.74,Entertainment,Nottingham,UK
540,28/02/2022,DEB,CONFETTI CONSTELLA,8.2,,3039.74,Home Improvement,Nottingham,UK
541,28/02/2022,FPO,MISS D WU,5.1,,3047.94,Services,Nottingham,UK
542,28/02/2022,FPO,MISS D WU,11.0,,3053.04,Services,Nottingham,UK
543,25/02/2022,DEB,SUMUP  *LTP,30.0,,3064.04,Services,Nottingham,UK
544,25/02/2022,DEB,ATRIUM JUBILEE 1,2.65,,3094.04,Dine Out,Nottingham,UK
545,25/02/2022,FPO,TRADING212UK,200.0,,3096.69,Investment,Nottingham,UK
546,25/02/2022,FPO,TRADING212UK,1000.0,,3296.69,Investment,Nottingham,UK
547,25/02/2022,FPI,PAULINA PIPPEN,,317.0,4296.69,Supplementary Income,Nottingham,UK
548,25/02/2022,DD,TALKTALK LIMITED,29.95,,3979.69,Bills,Nottingham,UK
549,25/02/2022,BP,SAVE THE CHANGE,0.01,,4009.64,Savings,Nottingham,UK
550,25/02/2022,BGC,UNIV OF NOTTINGHAM,,3801.83,4009.65,Paycheck,Nottingham,UK
551,24/02/2022,FPO,MISS D WU,10.0,,207.82,Services,Nottingham,UK
552,24/02/2022,DEB,Audible UK,7.99,,217.82,Entertainment,Nottingham,UK
553,24/02/2022,FPO,TAMBA TAM,10.0,,225.81,Services,Nottingham,UK
554,24/02/2022,FPO,MISS D WU,5.6,,235.81,Services,Nottingham,UK
555,24/02/2022,BP,SAVE THE CHANGE,1.15,,241.41,Savings,Nottingham,UK
556,23/02/2022,DEB,UBER   *TRIP,13.31,,242.56,Travel,,
557,23/02/2022,DEB,Subway 32610 Midla,10.88,,255.87,Dine Out,Nottingham,UK
558,23/02/2022,DEB,ATRIUM JUBILEE 1,9.75,,266.75,Dine Out,Nottingham,UK
559,23/02/2022,DEB,UBER* TRIP,7.91,,276.5,Travel,,
560,23/02/2022,FPO,TRADING212UK,200.0,,284.41,Investment,Nottingham,UK
561,23/02/2022,BP,SAVE THE CHANGE,0.51,,484.41,Savings,Nottingham,UK
562,22/02/2022,DEB,ORIENTAL MART HYDR,17.51,,484.92,Groceries,Nottingham,UK
563,22/02/2022,DEB,T K MAXX,5.98,,502.43,Other Shopping,,
564,22/02/2022,BP,SAVE THE CHANGE,1.26,,508.41,Savings,Nottingham,UK
565,21/02/2022,DEB,TESCO STORE 2960,35.54,,509.67,Groceries,,
566,21/02/2022,DEB,HEAVENLY DESSERTS,7.2,,545.21,Dine Out,Nottingham,UK
567,21/02/2022,BP,SAVE THE CHANGE,2.11,,552.41,Savings,Nottingham,UK
568,21/02/2022,DEB,AMZNMktplace,9.99,,554.52,Amazon,Nottingham,UK
569,21/02/2022,DEB,SAINSBURY S S/MKTS,1.69,,564.51,Groceries,,
570,21/02/2022,FPI,SHEILA SMITH,,380.0,566.2,Supplementary Income,Nottingham,UK
571,21/02/2022,DEB,LIDL GB  NOTTINGHA,19.65,,186.2,Groceries,Nottingham,UK
572,21/02/2022,FPO,MISS D WU,36.5,,205.85,Services,Nottingham,UK
573,21/02/2022,FPO,MISS D WU,10.0,,242.35,Services,Nottingham,UK
574,18/02/2022,DEB,AMZNMktplace,42.43,,252.35,Amazon,Nottingham,UK
575,18/02/2022,DEB,SUMUP  *LTP,15.0,,294.78,Services,Nottingham,UK
576,18/02/2022,DEB,Subway 32610 Midla,6.89,,309.78,Dine Out,Nottingham,UK
577,18/02/2022,DEB,ATRIUM JUBILEE 1,2.65,,316.67,Dine Out,Nottingham,UK
578,18/02/2022,DEB,JUBILEE SPAR,1.59,,319.32,Others,Nottingham,UK
579,18/02/2022,CPT,LNK TESCO HK R NOT,30.0,,320.91,Cash,nottingham,UK
580,17/02/2022,DD,VIRGIN MEDIA PYMTS,25.5,,350.91,Bills,Nottingham,UK
581,17/02/2022,BP,SAVE THE CHANGE,1.56,,376.41,Savings,Nottingham,UK
582,16/02/2022,DEB,Subway 32610 Midla,6.19,,377.97,Dine Out,Nottingham,UK
583,16/02/2022,DEB,ATRIUM JUBILEE 1,4.25,,384.16,Dine Out,Nottingham,UK
584,16/02/2022,DD,O2,16.66,,388.41,Other Shopping,Nottingham,UK
585,16/02/2022,BP,SAVE THE CHANGE,1.6,,405.07,Savings,Nottingham,UK
586,15/02/2022,DEB,THE CALCUTTA CLUB,93.85,,406.67,Dine Out,Nottingham,UK
587,15/02/2022,DEB,LIDL GB  NOTTINGHA,7.31,,500.52,Groceries,Nottingham,UK
588,15/02/2022,DEB,HPI INSTANT INK UK,3.49,,507.83,Other Shopping,,
589,15/02/2022,DEB,HEAVENLY DESSERTS,20.75,,511.32,Dine Out,Nottingham,UK
590,15/02/2022,DEB,THE CALCUTTA CLUB,,9.05,532.07,Supplementary Income,Nottingham,UK
591,15/02/2022,BP,SAVE THE CHANGE,1.73,,523.02,Savings,Nottingham,UK
592,14/02/2022,DEB,CINEWORLD NOT CP,17.98,,524.75,Entertainment,Nottingham,UK
593,14/02/2022,DEB,Subway 26377 Corne,11.68,,542.73,Dine Out,Nottingham,UK
594,14/02/2022,DEB,TESCO STORES 5954,4.05,,554.41,Groceries,,
595,14/02/2022,DEB,UBER   *TRIP,5.56,,558.46,Travel,,
596,14/02/2022,BP,SAVE THE CHANGE,3.03,,564.02,Savings,Nottingham,UK
597,14/02/2022,DEB,Kiehls since 1851,39.6,,567.05,Other Shopping,,
598,14/02/2022,DEB,LIDL GB NOTTINGHAM,35.04,,606.65,Groceries,Nottingham,UK
599,14/02/2022,DEB,LIDL GB NOTTINGHAM,31.26,,641.69,Groceries,Nottingham,UK
600,14/02/2022,DEB,The Body Shop,12.75,,672.95,Other Shopping,,
601,14/02/2022,DEB,AMZNMktplace,14.32,,685.7,Amazon,Nottingham,UK
602,14/02/2022,DEB,SUMUP  *HAVANA SAL,10.0,,700.02,Services,Nottingham,UK
603,14/02/2022,FPO,MISS D WU,7.0,,710.02,Services,Nottingham,UK
604,2022-11-02 00:00:00,FPO,MISS D WU,10.0,,717.02,Services,Nottingham,UK
605,2022-11-02 00:00:00,BP,SAVE THE CHANGE,0.94,,727.02,Savings,Nottingham,UK
606,2022-10-02 00:00:00,DEB,LIDL GB  NOTTINGHA,20.06,,727.96,Groceries,Nottingham,UK
607,2022-10-02 00:00:00,BP,SAVE THE CHANGE,0.73,,748.02,Savings,Nottingham,UK
608,2022-09-02 00:00:00,DEB,AMZNMktplace,47.68,,748.75,Amazon,Nottingham,UK
609,2022-09-02 00:00:00,DEB,AMZNMktplace,33.59,,796.43,Amazon,Nottingham,UK
610,2022-09-02 00:00:00,BP,SAVE THE CHANGE,0.35,,830.02,Savings,Nottingham,UK
611,2022-08-02 00:00:00,DEB,PRET A MANGER,30.65,,830.37,Dine Out,,
612,2022-08-02 00:00:00,BP,SAVE THE CHANGE,4.02,,861.02,Savings,Nottingham,UK
613,2022-07-02 00:00:00,DEB,EAST MIDS RAILWAY,66.5,,865.04,Travel,,
614,2022-07-02 00:00:00,DEB,UBER   *TRIP,18.3,,931.54,Travel,,
615,2022-07-02 00:00:00,DEB,GREGGS,10.2,,949.84,Dine Out,,
616,2022-07-02 00:00:00,DEB,UBER   *TRIP,8.83,,960.04,Travel,,
617,2022-07-02 00:00:00,DEB,UBER   *TRIP,8.47,,968.87,Travel,,
618,2022-07-02 00:00:00,DEB,UBER   *TRIP,7.15,,977.34,Travel,,
619,2022-07-02 00:00:00,DEB,UBER   *TRIP,6.0,,984.49,Travel,,
620,2022-07-02 00:00:00,DEB,UBER   *TRIP,9.71,,990.49,Travel,,
621,2022-07-02 00:00:00,DEB,UBER   *TRIP,8.82,,1000.2,Travel,,
622,2022-07-02 00:00:00,BP,SAVE THE CHANGE,3.63,,1009.02,Savings,Nottingham,UK
623,2022-07-02 00:00:00,FPO,MISS D WU,59.0,,1012.65,Services,Nottingham,UK
624,2022-07-02 00:00:00,DEB,MUANG THAI 9 LTD,45.95,,1071.65,Dine Out,London,UK
625,2022-07-02 00:00:00,DEB,STARBUCKS,17.64,,1117.6,Dine Out,,
626,2022-07-02 00:00:00,DEB,BOOTSKILBURN,4.89,,1135.24,Other Shopping,London,UK
627,2022-07-02 00:00:00,DEB,UBER   *TRIP,11.44,,1140.13,Travel,,
628,2022-07-02 00:00:00,DEB,MCDONALDS,10.51,,1151.57,Dine Out,,
629,2022-07-02 00:00:00,DEB,UBER   *TRIP,8.93,,1162.08,Travel,,
630,2022-07-02 00:00:00,DEB,WELCOME BREAK-NEWP,7.75,,1171.01,Others,Nottingham,UK
631,2022-07-02 00:00:00,DEB,TESCO STORES 5244,7.75,,1178.76,Groceries,,
632,2022-07-02 00:00:00,DEB,UBER   *TRIP,7.4,,1186.51,Travel,,
633,2022-07-02 00:00:00,DEB,UBER   *TRIP,1.0,,1193.91,Travel,,
634,2022-07-02 00:00:00,DEB,LIDL GB  NOTTINGHA,7.86,,1194.91,Groceries,Nottingham,UK
635,2022-04-02 00:00:00,DEB,ATRIUM JUBILEE 1,4.25,,1202.77,Dine Out,Nottingham,UK
636,2022-04-02 00:00:00,DEB,BookingUK (LTD),,30.6,1207.02,Supplementary Income,Nottingham,UK
637,2022-04-02 00:00:00,BP,SAVE THE CHANGE,0.46,,1176.42,Savings,Nottingham,UK
638,2022-03-02 00:00:00,DEB,BookingUK (LTD),187.96,,1176.88,Travel,,
639,2022-03-02 00:00:00,DEB,LIDL GB  NOTTINGHA,14.58,,1364.84,Groceries,Nottingham,UK
640,2022-03-02 00:00:00,BP,SAVE THE CHANGE,1.69,,1379.42,Savings,Nottingham,UK
641,2022-02-02 00:00:00,DEP,CLUB LLOYDS WAIVED,,3.0,1381.11,Supplementary Income,Nottingham,UK
642,2022-02-02 00:00:00,PAY,CLUB LLOYDS FEE,3.0,,1378.11,Bills,Nottingham,UK
643,2022-02-02 00:00:00,DEB,Subway 32610 Midla,6.19,,1381.11,Dine Out,Nottingham,UK
644,2022-02-02 00:00:00,DEB,LIDL GB NOTTINGHAM,5.47,,1387.3,Groceries,Nottingham,UK
645,2022-02-02 00:00:00,DEB,ATRIUM JUBILEE 1,2.65,,1392.77,Dine Out,Nottingham,UK
646,2022-02-02 00:00:00,FPO,MISS D WU,7.0,,1395.42,Services,Nottingham,UK
647,2022-02-02 00:00:00,CPT,LNK TESCO HK R NOT,50.0,,1402.42,Cash,nottingham,UK
648,2022-02-02 00:00:00,FPO,TAMBA TAM,8.0,,1452.42,Services,Nottingham,UK
649,2022-02-02 00:00:00,BP,SAVE THE CHANGE,0.35,,1460.42,Savings,Nottingham,UK
650,2022-01-02 00:00:00,,INTEREST (GROSS),,0.48,1460.77,Interest,Nottingham,UK
651,2022-01-02 00:00:00,DEB,AMZNMktplace,23.85,,1460.29,Amazon,Nottingham,UK
652,2022-01-02 00:00:00,DEB,HEAVENLY DESSERTS,17.8,,1484.14,Dine Out,Nottingham,UK
653,2022-01-02 00:00:00,TFR,R LAWRENCE,,150.0,1501.94,Supplementary Income,Nottingham,UK
654,2022-01-02 00:00:00,DD,BARCLAYS UK MTGES,981.71,,1351.94,Bills,Nottingham,UK
655,2022-01-02 00:00:00,DD,NOTTM CITY COUNC,157.0,,2333.65,Bills,Nottingham,UK
656,2022-01-02 00:00:00,DD,OCTOPUS ENERGY,90.0,,2490.65,Bills,Nottingham,UK
657,2022-01-02 00:00:00,DD,SEVERN TRENT WATER,41.89,,2580.65,Bills,Nottingham,UK
658,2022-01-02 00:00:00,SO,ESAVINGS ACCOUNT,300.0,,2622.54,Savings,Nottingham,UK
659,2022-01-02 00:00:00,BP,SAVE THE CHANGE,0.88,,2922.54,Savings,Nottingham,UK
660,31/01/2022,DEB,UBER   *TRIP,5.12,,2923.42,Travel,,
661,31/01/2022,DEB,UBER   *TRIP,1.0,,2928.54,Travel,,
662,31/01/2022,BP,SAVE THE CHANGE,2.48,,2929.54,Savings,Nottingham,UK
663,31/01/2022,DEB,LIDL GB NOTTINGHAM,58.54,,2932.02,Groceries,Nottingham,UK
664,31/01/2022,FPO,TAMBA TAM,10.0,,2990.56,Services,Nottingham,UK
665,31/01/2022,FPO,TAMBA TAM,10.0,,3000.56,Services,Nottingham,UK
666,31/01/2022,DEB,CASSAL RESTAURANTS,17.0,,3010.56,Dine Out,,
667,31/01/2022,DEB,AMZNMktplace,11.99,,3027.56,Amazon,Nottingham,UK
668,31/01/2022,FPO,MISS D WU,10.0,,3039.55,Services,Nottingham,UK
669,31/01/2022,FPO,MISS D WU,5.0,,3049.55,Services,Nottingham,UK
670,28/01/2022,DEB,SUMUP  *LTP,24.0,,3054.55,Services,Nottingham,UK
671,28/01/2022,DEB,Subway 32610 Midla,6.19,,3078.55,Dine Out,Nottingham,UK
672,28/01/2022,DEB,ATRIUM JUBILEE 1,4.25,,3084.74,Dine Out,Nottingham,UK
673,28/01/2022,DEB,TESCO STORES 5653,0.55,,3088.99,Groceries,,
674,28/01/2022,FPO,TRADING212UK,1100.0,,3089.54,Investment,Nottingham,UK
675,28/01/2022,DD,TALKTALK LIMITED,26.42,,4189.54,Bills,Nottingham,UK
676,28/01/2022,BP,SAVE THE CHANGE,0.77,,4215.96,Savings,Nottingham,UK
677,28/01/2022,BGC,UNIV OF NOTTINGHAM,,3801.84,4216.73,Paycheck,Nottingham,UK
678,27/01/2022,DEB,LIDL GB  NOTTINGHA,17.23,,414.89,Groceries,Nottingham,UK
679,27/01/2022,BP,SAVE THE CHANGE,0.92,,432.12,Savings,Nottingham,UK
680,26/01/2022,DEB,Subway 32610 Midla,6.99,,433.04,Dine Out,Nottingham,UK
681,26/01/2022,DEB,ATRIUM JUBILEE 1,2.65,,440.03,Dine Out,Nottingham,UK
682,26/01/2022,DEB,AMZNMktplace,48.44,,442.68,Amazon,Nottingham,UK
683,26/01/2022,FPO,TAMBA TAM,10.0,,491.12,Services,Nottingham,UK
684,26/01/2022,BP,SAVE THE CHANGE,0.83,,501.12,Savings,Nottingham,UK
685,26/01/2022,FPO,MISS D WU,7.0,,501.95,Services,Nottingham,UK
686,25/01/2022,DEB,YE OLDE TRIP TO JE,21.17,,508.95,Dine Out,Nottingham,UK
687,25/01/2022,FPO,TRADING212UK,200.0,,530.12,Investment,Nottingham,UK
688,25/01/2022,FPO,VINOTH VINCE,5.0,,730.12,Services,Nottingham,UK
689,25/01/2022,BP,SAVE THE CHANGE,1.21,,735.12,Savings,Nottingham,UK
690,24/01/2022,FPI,PAULINA PIPPEN,,320.0,736.33,Supplementary Income,Nottingham,UK
691,24/01/2022,DEB,Audible UK,7.99,,416.33,Entertainment,Nottingham,UK
692,24/01/2022,DEB,ROLLS ROYCE LEISUR,4.5,,424.32,Entertainment,Derby,UK
693,24/01/2022,DEB,ROLLS ROYCE LEISUR,4.3,,428.82,Entertainment,Derby,UK
694,24/01/2022,BP,SAVE THE CHANGE,1.46,,433.12,Savings,Nottingham,UK
695,24/01/2022,DEB,MOWGLI STREET FOOD,35.85,,434.58,Dine Out,Nottingham,UK
696,24/01/2022,DEB,NOTTINGHAM CASTLE,19.0,,470.43,Entertainment,Nottingham,UK
697,21/01/2022,DEB,LIDL GB NOTTINGHAM,18.94,,489.43,Groceries,Nottingham,UK
698,21/01/2022,DEB,ATRIUM JUBILEE 1,2.3,,508.37,Dine Out,Nottingham,UK
699,21/01/2022,DEB,CAFFE NERO NOTTING,9.45,,510.67,Dine Out,Nottingham,UK
700,21/01/2022,CPT,LNK TESCO HK R NOT,40.0,,520.12,Cash,nottingham,UK
701,21/01/2022,BP,SAVE THE CHANGE,0.57,,560.12,Savings,Nottingham,UK
702,20/01/2022,FPO,TRADING212UK,300.0,,560.69,Investment,Nottingham,UK
703,20/01/2022,FPI,SHEILA SMITH,,380.0,860.69,Supplementary Income,Nottingham,UK
704,20/01/2022,DEB,ORIENTAL MART HYDR,9.78,,480.69,Groceries,Nottingham,UK
705,20/01/2022,DEB,GREGGS,2.65,,490.47,Dine Out,,
706,20/01/2022,BP,SAVE THE CHANGE,1.31,,493.12,Savings,Nottingham,UK
707,19/01/2022,DEB,Subway 32610 Midla,6.19,,494.43,Dine Out,Nottingham,UK
708,19/01/2022,DEB,ATRIUM JUBILEE 1,2.5,,500.62,Dine Out,Nottingham,UK
709,19/01/2022,BP,SAVE THE CHANGE,0.69,,503.12,Savings,Nottingham,UK
710,18/01/2022,FPO,MISS D WU,6.0,,503.81,Services,Nottingham,UK
711,18/01/2022,FPO,TAMBA TAM,10.0,,509.81,Services,Nottingham,UK
712,18/01/2022,DEB,LIDL GB  NOTTINGHA,17.31,,519.81,Groceries,Nottingham,UK
713,18/01/2022,BP,SAVE THE CHANGE,0.1,,537.12,Savings,Nottingham,UK
714,17/01/2022,DEB,CAVES,19.9,,537.22,Entertainment,Nottingham,UK
715,17/01/2022,DD,VIRGIN MEDIA PYMTS,25.5,,557.12,Bills,Nottingham,UK
716,17/01/2022,DD,O2,17.06,,582.62,Other Shopping,Nottingham,UK
717,17/01/2022,BP,SAVE THE CHANGE,3.42,,599.68,Savings,Nottingham,UK
718,17/01/2022,DEB,MUSEUM,16.4,,603.1,Entertainment,,
719,17/01/2022,DEB,200 DEGREES,9.7,,619.5,Dine Out,Nottingham,UK
720,17/01/2022,DEB,POUNDLAND LTD 1718,8.75,,629.2,Groceries,Nottingham,UK
721,17/01/2022,FPO,TAMBA TAM,115.0,,637.95,Services,Nottingham,UK
722,17/01/2022,DEB,LIDL GB  NOTTINGHA,20.45,,752.95,Groceries,Nottingham,UK
723,14/01/2022,DEB,Subway 32610 Midla,6.19,,773.4,Dine Out,Nottingham,UK
724,14/01/2022,DEB,ORIENTAL MART HYDR,5.1,,779.59,Groceries,Nottingham,UK
725,14/01/2022,DEB,AMZNMktplace,12.99,,784.69,Amazon,Nottingham,UK
726,14/01/2022,BP,SAVE THE CHANGE,0.51,,797.68,Savings,Nottingham,UK
727,14/01/2022,FPO,ANTIGONI ABRAHMS,6.0,,798.19,Entertainment,London,UK
728,13/01/2022,DEB,HPI INSTANT INK UK,3.49,,804.19,Other Shopping,,
729,13/01/2022,BP,SAVE THE CHANGE,1.16,,807.68,Savings,Nottingham,UK
730,2022-12-01 00:00:00,DEB,TESCO STORE 2960,12.2,,808.84,Groceries,,
731,2022-12-01 00:00:00,DEB,Subway 32610 Midla,6.99,,821.04,Dine Out,Nottingham,UK
732,2022-12-01 00:00:00,DEB,ATRIUM JUBILEE 1,2.65,,828.03,Dine Out,Nottingham,UK
733,2022-12-01 00:00:00,BP,SAVE THE CHANGE,0.21,,830.68,Savings,Nottingham,UK
734,2022-11-01 00:00:00,DEB,RAJAH FOOD STORE L,38.79,,830.89,Groceries,Nottingham,UK
735,2022-11-01 00:00:00,BP,SAVE THE CHANGE,0.52,,869.68,Savings,Nottingham,UK
736,2022-10-01 00:00:00,DEB,YANKEE STORE,19.48,,870.2,Other Shopping,,
737,2022-10-01 00:00:00,BP,SAVE THE CHANGE,2.99,,889.68,Savings,Nottingham,UK
738,2022-10-01 00:00:00,DEB,DISCO BOWL NOTTING,20.5,,892.67,Entertainment,Nottingham,UK
739,2022-10-01 00:00:00,DEB,FUNSTATION,15.0,,913.17,Entertainment,Nottingham,UK
740,2022-10-01 00:00:00,DEB,MCDONALDS,13.87,,928.17,Dine Out,,
741,2022-10-01 00:00:00,DEB,POUNDLAND LTD 1718,13.0,,942.04,Groceries,Nottingham,UK
742,2022-10-01 00:00:00,DEB,POUNDLAND LTD 1726,7.5,,955.04,Groceries,Nottingham,UK
743,2022-10-01 00:00:00,DEB,LIDL GB NOTTINGHAM,5.67,,962.54,Groceries,Nottingham,UK
744,2022-10-01 00:00:00,DEB,UBER   *TRIP,5.12,,968.21,Travel,,
745,2022-10-01 00:00:00,DEB,UBER   *TRIP,1.0,,973.33,Travel,,
746,2022-10-01 00:00:00,DEB,AMZ*Zeina Foods,,14.5,974.33,Supplementary Income,Nottingham,UK
747,2022-07-01 00:00:00,DEB,TESCO STORE 2960,18.35,,959.83,Groceries,,
748,2022-07-01 00:00:00,BP,SAVE THE CHANGE,3.67,,978.18,Savings,Nottingham,UK
749,2022-06-01 00:00:00,FPO,MISS D WU,1.0,,981.85,Services,Nottingham,UK
750,2022-06-01 00:00:00,DEB,LIDL GB  NOTTINGHA,12.54,,982.85,Groceries,Nottingham,UK
751,2022-06-01 00:00:00,DEB,Subway 39497 Victo,6.19,,995.39,Dine Out,Nottingham,UK
752,2022-06-01 00:00:00,DEB,TESCO STORE 2960,1.15,,1001.58,Groceries,,
753,2022-06-01 00:00:00,DEB,AMZNMktplace,51.05,,1002.73,Amazon,Nottingham,UK
754,2022-06-01 00:00:00,DEB,Amazon.co.uk*PU3OT,6.4,,1053.78,Amazon,Nottingham,UK
755,2022-06-01 00:00:00,BP,SAVE THE CHANGE,0.09,,1060.18,Savings,Nottingham,UK
756,2022-05-01 00:00:00,DEP,CLUB LLOYDS WAIVED,,3.0,1060.27,Supplementary Income,Nottingham,UK
757,2022-05-01 00:00:00,PAY,CLUB LLOYDS FEE,3.0,,1057.27,Bills,Nottingham,UK
758,2022-05-01 00:00:00,DEB,UBER   *TRIP,5.91,,1060.27,Travel,,
759,2022-05-01 00:00:00,DEB,NEW STREET HCO,39.0,,1066.18,Clothes,,
760,2022-05-01 00:00:00,BP,SAVE THE CHANGE,1.51,,1105.18,Savings,Nottingham,UK
761,2022-04-01 00:00:00,,INTEREST (GROSS),,1.09,1106.69,Interest,Swansea,UK
762,2022-04-01 00:00:00,FPO,ROBERT RECORD,14.0,,1105.6,Others,Nottingham,UK
763,2022-04-01 00:00:00,DEB,BIRMINGHAM NS TVM,42.6,,1119.6,Hotels,Birmingham,UK
764,2022-04-01 00:00:00,DEB,WAGAMAMA BIRMINGHA,24.85,,1162.2,Dine Out,Birmingham,UK
765,2022-04-01 00:00:00,DEB,H & M,17.99,,1187.05,Clothes,,
766,2022-04-01 00:00:00,DEB,Caffe Concerto,15.05,,1205.04,Dine Out,London/birmingham,UK
767,2022-04-01 00:00:00,DEB,UBER   *TRIP,1.0,,1220.09,Travel,,
768,2022-04-01 00:00:00,FPO,TRADING212UK,700.0,,1221.09,Investment,Nottingham,UK
769,2022-04-01 00:00:00,DD,BARCLAYS UK MTGES,981.71,,1921.09,Bills,Nottingham,UK
770,2022-04-01 00:00:00,DD,NOTTM CITY COUNC,157.0,,2902.8,Bills,Nottingham,UK
771,2022-04-01 00:00:00,DD,OCTOPUS ENERGY,90.0,,3059.8,Bills,Nottingham,UK
772,2022-04-01 00:00:00,DD,SEVERN TRENT WATER,41.89,,3149.8,Bills,Nottingham,UK
773,2022-04-01 00:00:00,BP,Q WANG,,782.0,3191.69,Supplementary Income,Nottingham,UK
774,2022-04-01 00:00:00,SO,ESAVINGS ACCOUNT,300.0,,2409.69,Savings,Nottingham,UK
775,2022-04-01 00:00:00,BP,SAVE THE CHANGE,3.17,,2709.69,Savings,Nottingham,UK
776,2022-04-01 00:00:00,DEB,HOLIDAY INN EXPRES,65.0,,2712.86,Hotels,,
777,2022-04-01 00:00:00,DEB,LAS IGUANAS - TEMP,37.4,,2777.86,Dine Out,Nottingham,UK
778,2022-04-01 00:00:00,DEB,UBER   *TRIP,24.08,,2815.26,Travel,,
779,2022-04-01 00:00:00,DEB,AMZNMktplace,9.99,,2839.34,Amazon,Nottingham,UK
780,2022-04-01 00:00:00,DEB,HILTON HOTELS,1.0,,2849.33,Hotels,,
781,2022-04-01 00:00:00,DEB,AMZNMktplace,190.87,,2850.33,Amazon,Nottingham,UK
782,2022-04-01 00:00:00,DEB,HILTON HOTELS,235.0,,3041.2,Hotels,,
783,2022-04-01 00:00:00,DEB,VIETNAMESE STREET,31.46,,3276.2,Dine Out,Birmingham,UK
784,31/12/2021,DEB,LIDL GB  NOTTINGHA,11.58,,3307.66,Groceries,Nottingham,UK
785,31/12/2021,DEB,AMZNMktplace,13.45,,3319.24,Amazon,Nottingham,UK
786,31/12/2021,DD,TALKTALK LIMITED,21.0,,3332.69,Bills,Nottingham,UK
787,30/12/2021,BP,SAVE THE CHANGE,0.75,,3353.69,Savings,Nottingham,UK
788,29/12/2021,DEB,LIDL GB  NOTTINGHA,17.28,,3354.44,Groceries,Nottingham,UK
789,29/12/2021,DEB,AMZNMktplace,5.97,,3371.72,Amazon,Nottingham,UK
790,29/12/2021,BP,SAVE THE CHANGE,1.25,,3377.69,Savings,Nottingham,UK
791,29/12/2021,DEB,WILKO RETAIL LIMIT,13.0,,3378.94,Other Shopping,,
792,29/12/2021,DEB,UBER   *TRIP,12.42,,3391.94,Travel,Nottingham,UK
793,29/12/2021,DEB,UBER   *TRIP,1.0,,3404.36,Travel,Nottingham,UK
794,29/12/2021,FPO,TAMBA TAM,85.0,,3405.36,Services,Nottingham,UK
795,29/12/2021,DEB,AMZNMktplace,15.9,,3490.36,Amazon,Nottingham,UK
796,29/12/2021,DEB,AMZNMktplace,9.99,,3506.26,Amazon,Nottingham,UK
797,29/12/2021,FPO,TRADING212UK,200.0,,3516.25,Investment,Nottingham,UK
798,29/12/2021,CPT,LNK 583 MANSFIELD,100.0,,3716.25,Cash,Mansfiled,UK
799,29/12/2021,DEB,GOOGLE *YouTube Vi,3.49,,3816.25,,Nottingham,UK
800,29/12/2021,FPI,PAULINA PIPPEN,,320.0,3819.74,Supplementary Income,Nottingham,UK
801,24/12/2021,DEB,CINEWORLD NOT CP,31.97,,3499.74,Entertainment,Nottingham,UK
802,24/12/2021,DEB,AMZNMktplace,12.99,,3531.71,Amazon,Nottingham,UK
803,24/12/2021,DEB,Audible UK,7.99,,3544.7,Entertainment,Nottingham,UK
804,24/12/2021,BP,SAVE THE CHANGE,2.19,,3552.69,Savings,Nottingham,UK
805,23/12/2021,DEB,EAST MIDS RAILWAY,8.4,,3554.88,Travel,Nottingham,UK
806,23/12/2021,DEB,Subway 39497 Victo,6.19,,3563.28,Dine Out,Nottingham,UK
807,23/12/2021,DEB,AMZNMktplace,14.95,,3569.47,Amazon,Nottingham,UK
808,23/12/2021,DEB,AMZNMktplace,11.27,,3584.42,Amazon,Nottingham,UK
809,23/12/2021,BP,SAVE THE CHANGE,0.24,,3595.69,Savings,Nottingham,UK
810,22/12/2021,DEB,LIDL GB  NOTTINGHA,10.76,,3595.93,Groceries,Nottingham,UK
811,22/12/2021,FPO,TRADING212UK,1000.0,,3606.69,Investment,Nottingham,UK
812,22/12/2021,BP,SAVE THE CHANGE,0.6,,4606.69,Savings,Nottingham,UK
813,22/12/2021,BGC,UNIV OF NOTTINGHAM,,3801.43,4607.29,Paycheck,Nottingham,UK
814,21/12/2021,DEB,LIDL GB  NOTTINGHA,27.61,,805.86,Groceries,Nottingham,UK
815,21/12/2021,DEB,HOLLAND & BARRETT,15.98,,833.47,Groceries,,
816,21/12/2021,DEB,T K MAXX,11.97,,849.45,Other Shopping,,
817,21/12/2021,DEB,ORIENTAL MART HYDR,8.85,,861.42,Groceries,Nottingham,UK
818,21/12/2021,DEB,AMZNMktplace,13.99,,870.27,Amazon,Nottingham,UK
819,21/12/2021,FPO,TRADING212UK,100.0,,884.26,Investment,Nottingham,UK
820,21/12/2021,FPO,TRADING212UK,700.0,,984.26,Investment,Nottingham,UK
821,21/12/2021,FPI,Q WANG,,1000.0,1684.26,Supplementary Income,Nottingham,UK
822,21/12/2021,BP,SAVE THE CHANGE,0.6,,684.26,Savings,Nottingham,UK
823,20/12/2021,FPO,TRADING212UK,300.0,,684.86,Investment,Nottingham,UK
824,20/12/2021,FPI,SHEILA SMITH,,380.0,984.86,Supplementary Income,Nottingham,UK
825,20/12/2021,DEB,SAINSBURYS S/MKTS,34.4,,604.86,Groceries,,
826,20/12/2021,BP,SAVE THE CHANGE,1.08,,639.26,Savings,Nottingham,UK
827,20/12/2021,DEB,AMZNMktplace,5.99,,640.34,Amazon,Nottingham,UK
828,17/12/2021,DEB,BIRMINGHAM NS T/O,17.0,,646.33,Hotels,Birmingham,UK
829,17/12/2021,DEB,ATRIUM JUBILEE 1,4.25,,663.33,Dine Out,Nottingham,UK
830,17/12/2021,DEB,AMZNMktplace,31.99,,667.58,Amazon,Nottingham,UK
831,17/12/2021,DEB,Amazon.co.uk*8J9B3,6.69,,699.57,Amazon,Nottingham,UK
832,17/12/2021,DEB,ANTIGONI ABRAHMS,6.0,,706.26,Entertainment,London,UK
833,17/12/2021,TFR,R LAWRENCE,,300.0,712.26,Supplementary Income,Nottingham,UK
834,17/12/2021,FPO,MR J LITCHFIELD,340.0,,412.26,Services,Nottingham,UK
835,17/12/2021,DD,VIRGIN MEDIA PYMTS,25.5,,752.26,Bills,Nottingham,UK
836,17/12/2021,BP,SAVE THE CHANGE,3.0,,777.76,Savings,Nottingham,UK
837,16/12/2021,DEB,COMFORT INN BIRMIN,53.1,,780.76,Hotels,Birmingham,UK
838,16/12/2021,DEB,NANDOS BULLRING,39.1,,833.86,Dine Out,Birmingham,UK
839,16/12/2021,DEB,EAST MIDS RAILWAY,27.5,,872.96,Travel,Nottingham,UK
840,16/12/2021,DEB,WAGAMAMA BIRMINGHA,16.8,,900.46,Dine Out,Birmingham,UK
841,16/12/2021,DEB,DANTER ATTRACTIONS,7.0,,917.26,Entertainment,Birmingham,UK
842,16/12/2021,DEB,DANTER ATTRACTIONS,7.0,,924.26,Entertainment,Birmingham,UK
843,16/12/2021,DEB,IZ *EPICURIOSITY L,5.5,,931.26,Groceries,,
844,16/12/2021,DEB,STARBUCKS,4.0,,936.76,Dine Out,,
845,16/12/2021,DD,O2,16.66,,940.76,Other Shopping,Nottingham,UK
846,16/12/2021,BP,SAVE THE CHANGE,0.82,,957.42,Savings,Nottingham,UK
847,15/12/2021,DEB,Subway 32610 Midla,6.19,,958.24,Dine Out,Nottingham,UK
848,15/12/2021,DEB,AMZNMKTPLACE AMAZO,11.99,,964.43,Amazon,Nottingham,UK
849,15/12/2021,CPT,LOYD LOYD 36 - 38,40.0,,976.42,Cash,Birmingham,UK
850,15/12/2021,BP,SAVE THE CHANGE,1.4,,1016.42,Savings,Nottingham,UK
851,14/12/2021,FPO,TAMBA TAM,10.0,,1017.82,Services,Nottingham,UK
852,14/12/2021,DEB,LIDL GB  NOTTINGHA,25.12,,1027.82,Groceries,Nottingham,UK
853,14/12/2021,DEB,AMZNMktplace,12.99,,1052.94,Amazon,Nottingham,UK
854,14/12/2021,DEB,HPI INSTANT INK UK,3.49,,1065.93,Other Shopping,,
855,14/12/2021,BP,SAVE THE CHANGE,0.5,,1069.42,Savings,Nottingham,UK
856,13/12/2021,DEB,Audible UK,18.0,,1069.92,Entertainment,Nottingham,UK
857,13/12/2021,DEB,SUMUP  *CODE 34,22.5,,1087.92,Services,Nottingham,UK
858,13/12/2021,BP,SAVE THE CHANGE,2.78,,1110.42,Savings,Nottingham,UK
859,13/12/2021,DEB,LAND ROVER SOCIAL,5.55,,1113.2,Entertainment,Solihull,UK
860,13/12/2021,DEB,THE BLIND RABBIT,9.25,,1118.75,Dine Out,Nottingham,UK
861,13/12/2021,DEB,THE BLIND RABBIT,7.95,,1128.0,Dine Out,Nottingham,UK
862,13/12/2021,FPO,TAMBA TAM,15.0,,1135.95,Services,Nottingham,UK
863,13/12/2021,DEB,No. Twelve,45.63,,1150.95,Dine Out,Nottingham,UK
864,13/12/2021,DEB,ATRIUM JUBILEE 1,2.65,,1196.58,Dine Out,Nottingham,UK
865,2021-10-12 00:00:00,DEP,CLUB LLOYDS WAIVED,,3.0,1199.23,Supplementary Income,Nottingham,UK
866,2021-10-12 00:00:00,PAY,CLUB LLOYDS FEE,3.0,,1196.23,Bills,Nottingham,UK
867,2021-10-12 00:00:00,DEB,Subway 32610 Midla,6.19,,1199.23,Dine Out,Nottingham,UK
868,2021-10-12 00:00:00,DEB,ANTIGONI ABRAHMS,6.0,,1205.42,Entertainment,London,UK
869,2021-09-12 00:00:00,BP,SAVE THE CHANGE,0.42,,1211.42,Savings,Nottingham,UK
870,2021-08-12 00:00:00,DEB,AMZNMktplace,9.99,,1211.84,Amazon,Nottingham,UK
871,2021-08-12 00:00:00,DEB,AMZNMktplace,8.59,,1221.83,Amazon,Nottingham,UK
872,2021-08-12 00:00:00,BP,SAVE THE CHANGE,0.8,,1230.42,Savings,Nottingham,UK
873,2021-07-12 00:00:00,FPO,TAMBA TAM,10.0,,1231.22,Services,Nottingham,UK
874,2021-07-12 00:00:00,FPO,TAMBA TAM,95.0,,1241.22,Services,Nottingham,UK
875,2021-07-12 00:00:00,DEB,LIDL GB  NOTTINGHA,17.2,,1336.22,Groceries,Nottingham,UK
876,2021-07-12 00:00:00,BP,SAVE THE CHANGE,0.63,,1353.42,Savings,Nottingham,UK
877,2021-06-12 00:00:00,DEB,ORIENTAL MART HYDR,27.97,,1354.05,Groceries,Nottingham,UK
878,2021-06-12 00:00:00,DEB,TESCO STORES 6735,3.4,,1382.02,Groceries,,
879,2021-06-12 00:00:00,BP,SAVE THE CHANGE,1.56,,1385.42,Savings,Nottingham,UK
880,2021-06-12 00:00:00,CPT,LNK TESCO LONG ROW,40.0,,1386.98,Cash,Nottingham,UK
881,2021-06-12 00:00:00,DEB,SUMUP  *TODO LATIN,10.0,,1426.98,Entertainment,Nottingham,UK
882,2021-06-12 00:00:00,DEB,ATRIUM JUBILEE 1,4.25,,1436.98,Dine Out,Nottingham,UK
883,2021-03-12 00:00:00,FPO,ANDREW MUMBI,24.0,,1441.23,Services,Nottingham,UK
884,2021-03-12 00:00:00,DEB,Subway 32610 Midla,6.19,,1465.23,Dine Out,Nottingham,UK
885,2021-03-12 00:00:00,BP,SAVE THE CHANGE,0.15,,1471.42,Savings,Nottingham,UK
886,2021-02-12 00:00:00,DEB,ANTIGONI ABRAHMS,6.0,,1471.57,Entertainment,London,UK
887,2021-02-12 00:00:00,DEB,LIDL GB  NOTTINGHA,10.85,,1477.57,Groceries,Nottingham,UK
888,2021-02-12 00:00:00,BP,SAVE THE CHANGE,0.82,,1488.42,Savings,Nottingham,UK
889,2021-01-12 00:00:00,,INTEREST (GROSS),,0.68,1489.24,Interest,Nottingham,UK
890,2021-01-12 00:00:00,FPO,VINOTH VINCE,10.0,,1488.56,Services,Nottingham,UK
891,2021-01-12 00:00:00,DEB,Amazon.co.uk*072AV,12.99,,1498.56,Amazon,Nottingham,UK
892,2021-01-12 00:00:00,DEB,Subway 32610 Midla,6.19,,1511.55,Dine Out,Nottingham,UK
893,2021-01-12 00:00:00,TFR,R LAWRENCE,,191.99,1517.74,Supplementary Income,Nottingham,UK
894,2021-01-12 00:00:00,DD,BARCLAYS UK MTGES,981.71,,1325.75,Bills,Nottingham,UK
895,2021-01-12 00:00:00,DD,NOTTM CITY COUNC,157.0,,2307.46,Bills,Nottingham,UK
896,2021-01-12 00:00:00,DD,OCTOPUS ENERGY,90.0,,2464.46,Bills,Nottingham,UK
897,2021-01-12 00:00:00,DD,SEVERN TRENT WATER,41.86,,2554.46,Bills,Nottingham,UK
898,2021-01-12 00:00:00,SO,ESAVINGS ACCOUNT,300.0,,2596.32,Savings,Nottingham,UK
899,2021-01-12 00:00:00,BP,SAVE THE CHANGE,0.34,,2896.32,Savings,Nottingham,UK
900,30/11/2021,FPO,TAMBA TAM,10.0,,2896.66,Services,Nottingham,UK
901,30/11/2021,DEB,RAJAH FOOD STORE L,7.66,,2906.66,Groceries,Nottingham,UK
902,30/11/2021,BP,SAVE THE CHANGE,1.19,,2914.32,Savings,Nottingham,UK
903,29/11/2021,DEB,REVOLUTION DE CUBA,8.75,,2915.51,Dine Out,Nottingham,UK
904,29/11/2021,DEB,REVOLUTION DE CUBA,8.75,,2924.26,Dine Out,Nottingham,UK
905,29/11/2021,DEB,UBER   *EATS,35.31,,2933.01,Dine Out,,
906,29/11/2021,FPO,TRADING212UK,1500.0,,2968.32,Investment,Nottingham,UK
907,29/11/2021,BP,SAVE THE CHANGE,1.95,,4468.32,Savings,Nottingham,UK
908,29/11/2021,BGC,UNIV OF NOTTINGHAM,,3801.83,4470.27,Paycheck,Nottingham,UK
909,29/11/2021,FPO,ANDREW MUMBI,15.0,,668.44,Services,Nottingham,UK
910,29/11/2021,DEB,LIDL GB  NOTTINGHA,19.39,,683.44,Groceries,Nottingham,UK
911,29/11/2021,DEB,LIDL GB  NOTTINGHA,18.99,,702.83,Groceries,Nottingham,UK
912,29/11/2021,DEB,AMZNMktplace,6.49,,721.82,Amazon,Nottingham,UK
913,26/11/2021,DEB,AMZNMktplace,9.99,,728.31,Amazon,Nottingham,UK
914,26/11/2021,DEB,Subway 32610 Midla,6.19,,738.3,Dine Out,Nottingham,UK
915,26/11/2021,FPO,TRADING212UK,400.0,,744.49,Investment,Nottingham,UK
916,26/11/2021,FPI,P PROKURAT,,320.0,1144.49,Supplementary Income,Nottingham,UK
917,26/11/2021,DD,TALKTALK LIMITED,21.0,,824.49,Bills,Nottingham,UK
918,25/11/2021,DEB,ANTIGONI ABRAHMS,6.0,,845.49,Entertainment,London,UK
919,25/11/2021,BP,SAVE THE CHANGE,0.82,,851.49,Savings,Nottingham,UK
920,24/11/2021,FPO,TAMBA TAM,10.0,,852.31,Services,Nottingham,UK
921,24/11/2021,FPO,MARIA DONNARUMMA,75.0,,862.31,Services,Nottingham,UK
922,24/11/2021,DEB,Audible UK,7.99,,937.31,Entertainment,Nottingham,UK
923,24/11/2021,DEB,Subway 32610 Midla,6.19,,945.3,Dine Out,Nottingham,UK
924,24/11/2021,BP,SAVE THE CHANGE,0.94,,951.49,Savings,Nottingham,UK
925,24/11/2021,BGC,GOOGLE IRELAND,,63.7,952.43,Supplementary Income,Nottingham,UK
926,23/11/2021,DEB,LIDL GB  NOTTINGHA,17.19,,888.73,Groceries,Nottingham,UK
927,23/11/2021,DEB,RAJAH FOOD STORE L,11.87,,905.92,Groceries,Nottingham,UK
928,23/11/2021,BP,SAVE THE CHANGE,0.13,,917.79,Savings,Nottingham,UK
929,22/11/2021,DEB,AMZNMktplace,17.87,,917.92,Amazon,Nottingham,UK
930,22/11/2021,BP,SAVE THE CHANGE,5.4,,935.79,Savings,Nottingham,UK
931,22/11/2021,DEB,LIDL GB  NOTTINGHA,23.44,,941.19,Groceries,Nottingham,UK
932,22/11/2021,DEB,ORIENTAL MART HYDR,13.11,,964.63,Groceries,Nottingham,UK
933,22/11/2021,DEB,AMZNMktplace,10.99,,977.74,Amazon,Nottingham,UK
934,22/11/2021,DEB,WILKO RETAIL LIMIT,7.75,,988.73,Other Shopping,,
935,22/11/2021,DEB,200 DEGREES,5.9,,996.48,Dine Out,Nottingham,UK
936,22/11/2021,DEB,HOLLAND & BARRETT,4.35,,1002.38,Groceries,,
937,22/11/2021,FPO,TAMBA TAM,10.0,,1006.73,Services,Nottingham,UK
938,22/11/2021,DEB,Subway 32610 Midla,6.19,,1016.73,Dine Out,Nottingham,UK
939,22/11/2021,DEB,STARBUCKS,6.1,,1022.92,Dine Out,,
940,22/11/2021,FPI,SHEILA SMITH,,380.0,1029.02,Supplementary Income,Nottingham,UK
941,19/11/2021,DEB,LIDL GB  NOTTINGHA,12.52,,649.02,Groceries,Nottingham,UK
942,19/11/2021,DEB,ATRIUM JUBILEE 1,4.25,,661.54,Dine Out,Nottingham,UK
943,19/11/2021,FPO,TRADING212UK,400.0,,665.79,Investment,Nottingham,UK
944,19/11/2021,BP,SAVE THE CHANGE,0.51,,1065.79,Savings,Nottingham,UK
945,18/11/2021,DEB,HPI INSTANT INK UK,3.49,,1066.3,Other Shopping,,
946,18/11/2021,BP,SAVE THE CHANGE,1.72,,1069.79,Savings,Nottingham,UK
947,17/11/2021,DEB,AMZNMktplace,25.44,,1071.51,Amazon,Nottingham,UK
948,17/11/2021,DEB,Subway 32610 Midla,6.19,,1096.95,Dine Out,Nottingham,UK
949,17/11/2021,DEB,ATRIUM JUBILEE 1,2.65,,1103.14,Dine Out,Nottingham,UK
950,17/11/2021,DD,VIRGIN MEDIA PYMTS,25.5,,1105.79,Bills,Nottingham,UK
951,17/11/2021,BP,SAVE THE CHANGE,1.0,,1131.29,Savings,Nottingham,UK
952,16/11/2021,FPO,TAMBA TAM,10.0,,1132.29,Services,Nottingham,UK
953,16/11/2021,DEB,LIDL GB  NOTTINGHA,23.9,,1142.29,Groceries,Nottingham,UK
954,16/11/2021,DEB,Amazon.co.uk*Y39VW,8.1,,1166.19,Amazon,Nottingham,UK
955,16/11/2021,DD,O2,16.66,,1174.29,Other Shopping,Nottingham,UK
956,15/11/2021,DEB,BLEND COFFEE HOUSE,3.0,,1190.95,Dine Out,Nottingham,UK
957,15/11/2021,DEB,SUMUP  *LOS TRAVIE,70.0,,1193.95,Services,Nottingham,UK
958,15/11/2021,BP,SAVE THE CHANGE,2.59,,1263.95,Savings,Nottingham,UK
959,15/11/2021,DEB,JURYS INN EAST MID,12.55,,1266.54,Hotels,Derby,UK
960,15/11/2021,DEB,ATRIUM JUBILEE 1,4.25,,1279.09,Dine Out,Nottingham,UK
961,15/11/2021,DEB,AMZNMktplace,2.77,,1283.34,Amazon,Nottingham,UK
962,2021-12-11 00:00:00,DEB,Subway 32610 Midla,6.19,,1286.11,Dine Out,Nottingham,UK
963,2021-12-11 00:00:00,DEB,ANTIGONI ABRAHMS,6.0,,1292.3,Entertainment,London,UK
964,2021-12-11 00:00:00,DEB,ATRIUM JUBILEE 1,2.65,,1298.3,Dine Out,Nottingham,UK
965,2021-12-11 00:00:00,BP,SAVE THE CHANGE,0.76,,1300.95,Savings,Nottingham,UK
966,2021-11-11 00:00:00,DEB,LIDL GB  NOTTINGHA,20.24,,1301.71,Groceries,Nottingham,UK
967,2021-11-11 00:00:00,FPO,TRADING212UK,400.0,,1321.95,Investment,Nottingham,UK
968,2021-11-11 00:00:00,BP,SAVE THE CHANGE,1.16,,1721.95,Savings,Nottingham,UK
969,2021-10-11 00:00:00,DEB,Subway 32610 Midla,6.19,,1723.11,Dine Out,Nottingham,UK
970,2021-10-11 00:00:00,DEB,ATRIUM JUBILEE 1,2.65,,1729.3,Dine Out,Nottingham,UK
971,2021-10-11 00:00:00,FPO,L CATATE,20.0,,1731.95,,Nottingham,UK
972,2021-10-11 00:00:00,FPO,TAMBA TAM,10.0,,1751.95,Services,Nottingham,UK
973,2021-09-11 00:00:00,BP,SAVE THE CHANGE,0.35,,1761.95,Savings,Nottingham,UK
974,2021-08-11 00:00:00,DEB,LIDL GB  NOTTINGHA,18.9,,1762.3,Groceries,Nottingham,UK
975,2021-08-11 00:00:00,DEB,REVOLUTION DE CUBA,8.75,,1781.2,Dine Out,Nottingham,UK
976,2021-08-11 00:00:00,BP,SAVE THE CHANGE,2.82,,1789.95,Savings,Nottingham,UK
977,2021-08-11 00:00:00,DEB,ORIENTAL MART HYDR,5.49,,1792.77,Groceries,Nottingham,UK
978,2021-08-11 00:00:00,DEB,ATRIUM JUBILEE 1,4.25,,1798.26,Dine Out,Nottingham,UK
979,2021-05-11 00:00:00,DEB,Subway 32610 Midla,6.19,,1802.51,Dine Out,Nottingham,UK
980,2021-05-11 00:00:00,DEB,ATRIUM JUBILEE 1,4.25,,1808.7,Dine Out,Nottingham,UK
981,2021-05-11 00:00:00,BP,SAVE THE CHANGE,0.08,,1812.95,Savings,Nottingham,UK
982,2021-04-11 00:00:00,DEB,LIDL GB  NOTTINGHA,9.92,,1813.03,Groceries,Nottingham,UK
983,2021-04-11 00:00:00,BP,SAVE THE CHANGE,1.16,,1822.95,Savings,Nottingham,UK
984,2021-03-11 00:00:00,DEB,Subway 32610 Midla,6.19,,1824.11,Dine Out,Nottingham,UK
985,2021-03-11 00:00:00,DEB,ATRIUM JUBILEE 1,2.65,,1830.3,Dine Out,Nottingham,UK
986,2021-03-11 00:00:00,FPO,TAMBA TAM,10.0,,1832.95,Services,Nottingham,UK
987,2021-03-11 00:00:00,BP,SAVE THE CHANGE,1.23,,1842.95,Savings,Nottingham,UK
988,2021-02-11 00:00:00,DEP,CLUB LLOYDS WAIVED,,3.0,1844.18,Supplementary Income,Nottingham,UK
989,2021-02-11 00:00:00,PAY,CLUB LLOYDS FEE,3.0,,1841.18,Bills,Nottingham,UK
990,2021-02-11 00:00:00,DEB,LIDL GB  NOTTINGHA,5.12,,1844.18,Groceries,Nottingham,UK
991,2021-02-11 00:00:00,DEB,ATRIUM JUBILEE 1,2.65,,1849.3,Dine Out,Nottingham,UK
992,2021-02-11 00:00:00,FPO,TRADING212UK,500.0,,1851.95,Investment,Nottingham,UK
993,2021-01-11 00:00:00,,INTEREST (GROSS),,0.78,2351.95,Interest,Nottingham,UK
994,2021-01-11 00:00:00,FPI,Q WANG,,1000.0,2351.17,Supplementary Income,Nottingham,UK
995,2021-01-11 00:00:00,DD,BARCLAYS UK MTGES,981.71,,1351.17,Bills,Nottingham,UK
996,2021-01-11 00:00:00,DD,NOTTM CITY COUNC,157.0,,2332.88,Bills,Nottingham,UK
997,2021-01-11 00:00:00,DD,OCTOPUS ENERGY,90.0,,2489.88,Bills,Nottingham,UK
998,2021-01-11 00:00:00,DD,SEVERN TRENT WATER,35.32,,2579.88,Bills,Nottingham,UK
999,2021-01-11 00:00:00,SO,ESAVINGS ACCOUNT,300.0,,2615.2,Savings,Nottingham,UK
1000,2021-01-11 00:00:00,BP,SAVE THE CHANGE,1.76,,2915.2,Savings,Nottingham,UK
1001,2021-01-11 00:00:00,DEB,LIDL GB  NOTTINGHA,10.8,,2916.96,Groceries,Nottingham,UK
1002,2021-01-11 00:00:00,DEB,STARBUCKS,5.6,,2927.76,Dine Out,,
1003,29/10/2021,DEB,Subway 32610 Midla,6.19,,2933.36,Dine Out,Nottingham,UK
1004,29/10/2021,DEB,FALAFEL,6.0,,2939.55,Dine Out,Nottingham,UK
1005,29/10/2021,DEB,FALAFEL,3.0,,2945.55,Dine Out,Nottingham,UK
1006,29/10/2021,DEB,ATRIUM JUBILEE 1,2.65,,2948.55,Dine Out,Nottingham,UK
1007,29/10/2021,FPO,TRADING212UK,1200.0,,2951.2,Investment,Nottingham,UK
1008,29/10/2021,DD,TALKTALK LIMITED,21.0,,4151.2,Bills,Nottingham,UK
1009,29/10/2021,BP,SAVE THE CHANGE,0.43,,4172.2,Savings,Nottingham,UK
1010,28/10/2021,DEB,ANTIGONI ABRAHMS,6.0,,4172.63,Entertainment,London,UK
1011,28/10/2021,DEB,LIDL GB  NOTTINGHA,13.57,,4178.63,Groceries,Nottingham,UK
1012,28/10/2021,BP,SAVE THE CHANGE,1.16,,4192.2,Savings,Nottingham,UK
1013,28/10/2021,BGC,UNIV OF NOTTINGHAM,,3801.44,4193.36,Paycheck,Nottingham,UK
1014,27/10/2021,FPO,TAMBA TAM,10.0,,391.92,Services,Nottingham,UK
1015,27/10/2021,DEB,Subway 32610 Midla,6.19,,401.92,Dine Out,Nottingham,UK
1016,27/10/2021,DEB,ATRIUM JUBILEE 1,1.65,,408.11,Dine Out,Nottingham,UK
1017,26/10/2021,FPO,TRADING212UK,350.0,,409.76,Investment,Nottingham,UK
1018,26/10/2021,BP,SAVE THE CHANGE,0.54,,759.76,Savings,Nottingham,UK
1019,25/10/2021,DEB,REVOLUTION DE CUBA,9.75,,760.3,Dine Out,Nottingham,UK
1020,25/10/2021,DEB,CARTWHEEL COFFEE L,6.71,,770.05,Dine Out,Nottingham,UK
1021,25/10/2021,BP,SAVE THE CHANGE,2.81,,776.76,Savings,Nottingham,UK
1022,25/10/2021,DEB,PRICKLY PEAR,91.5,,779.57,Dine Out,Nottingham,UK
1023,25/10/2021,DEB,ORIENTAL MART HYDR,8.33,,871.07,Groceries,Nottingham,UK
1024,25/10/2021,DEB,Audible UK,7.99,,879.4,Entertainment,Nottingham,UK
1025,25/10/2021,DEB,LIDL GB  NOTTINGHA,21.18,,887.39,Groceries,Nottingham,UK
1026,22/10/2021,DEB,Subway 32610 Midla,6.19,,908.57,Dine Out,Nottingham,UK
1027,22/10/2021,FPI,PAULINA PIPPEN,,320.0,914.76,Supplementary Income,Nottingham,UK
1028,22/10/2021,FPO,TRADING212UK,400.0,,594.76,Investment,Nottingham,UK
1029,22/10/2021,BP,SAVE THE CHANGE,0.97,,994.76,Savings,Nottingham,UK
1030,21/10/2021,FPO,ANTIGONI ABRAHMS,6.0,,995.73,Entertainment,London,UK
1031,21/10/2021,DEB,SAINSBURYS S/MKTS,29.3,,1001.73,Groceries,,
1032,21/10/2021,DEB,AMZNMktplace,25.73,,1031.03,Amazon,Nottingham,UK
1033,21/10/2021,BP,SAVE THE CHANGE,0.81,,1056.76,Savings,Nottingham,UK
1034,20/10/2021,FPI,SHEILA SMITH,,380.0,1057.57,Supplementary Income,Nottingham,UK
1035,20/10/2021,DEB,Subway 32610 Midla,6.19,,677.57,Dine Out,Nottingham,UK
1036,20/10/2021,FPO,TAMBA TAM,10.0,,683.76,Services,Nottingham,UK
1037,20/10/2021,BP,SAVE THE CHANGE,0.71,,693.76,Savings,Nottingham,UK
1038,19/10/2021,DEB,SP * HOMEDETAIL-UK,239.0,,694.47,Home Improvement,Nottingham,UK
1039,19/10/2021,DEB,NON-GBP PURCH FEE,0.5,,933.47,Others,Nottingham,UK
1040,19/10/2021,DEB,NON-GBP TRANS FEE,0.54,,933.97,Others,Nottingham,UK
1041,19/10/2021,DEB,EB 2021 IEEE CONFE,18.29,,934.51,Travel,Nottingham,UK
1042,19/10/2021,CPT,LNK NOTTINGHAM UNI,40.0,,952.8,Cash,Nottingham,UK
1043,19/10/2021,FPO,TRADING212UK,200.0,,992.8,Investment,Nottingham,UK
1044,19/10/2021,BP,SAVE THE CHANGE,1.42,,1192.8,Savings,Nottingham,UK
1045,18/10/2021,DEB,AMZNMktplace,15.49,,1194.22,Amazon,Nottingham,UK
1046,18/10/2021,DEB,AMZNMktplace,9.99,,1209.71,Amazon,Nottingham,UK
1047,18/10/2021,DEB,REVOLUTION DE CUBA,8.75,,1219.7,Dine Out,Nottingham,UK
1048,18/10/2021,DEB,CAFFE NERO NOTTING,3.35,,1228.45,Dine Out,Nottingham,UK
1049,18/10/2021,DEB,GREGGS PLC,2.0,,1231.8,Dine Out,,
1050,18/10/2021,DD,VIRGIN MEDIA PYMTS,25.5,,1233.8,Bills,Nottingham,UK
1051,18/10/2021,DD,O2,16.66,,1259.3,Other Shopping,Nottingham,UK
1052,18/10/2021,BP,SAVE THE CHANGE,3.19,,1275.96,Savings,Nottingham,UK
1053,18/10/2021,DEB,LIDL GB  NOTTINGHA,8.87,,1279.15,Groceries,Nottingham,UK
1054,18/10/2021,DEB,ATRIUM JUBILEE 1,2.65,,1288.02,Dine Out,Nottingham,UK
1055,15/10/2021,DEB,Subway 32610 Midla,6.19,,1290.67,Dine Out,Nottingham,UK
1056,15/10/2021,DEB,SOUTHBANK BAR,5.6,,1296.86,Dine Out,Nottingham,UK
1057,15/10/2021,DEB,ATRIUM JUBILEE 1,4.25,,1302.46,Dine Out,Nottingham,UK
1058,15/10/2021,DEB,TESCO STORES 6735,2.25,,1306.71,Groceries,,
1059,15/10/2021,BP,SAVE THE CHANGE,0.51,,1308.96,Savings,Nottingham,UK
1060,14/10/2021,FPO,ANTIGONI ABRAHMS,6.0,,1309.47,Entertainment,London,UK
1061,14/10/2021,DEB,HPI INSTANT INK UK,3.49,,1315.47,Other Shopping,,
1062,14/10/2021,BP,SAVE THE CHANGE,1.77,,1318.96,Savings,Nottingham,UK
1063,13/10/2021,DEB,AMZNMktplace,35.04,,1320.73,Amazon,Nottingham,UK
1064,13/10/2021,DEB,Subway 32610 Midla,6.19,,1355.77,Dine Out,Nottingham,UK
1065,13/10/2021,TFR,R LAWRENCE,,400.0,1361.96,Supplementary Income,Nottingham,UK
1066,13/10/2021,FPO,MR J LITCHFIELD,481.0,,961.96,Services,Nottingham,UK
1067,13/10/2021,BP,SAVE THE CHANGE,0.03,,1442.96,Savings,Nottingham,UK
1068,2021-12-10 00:00:00,FPO,TAMBA TAM,10.0,,1442.99,Services,Nottingham,UK
1069,2021-12-10 00:00:00,DEB,LIDL GB  NOTTINGHA,5.97,,1452.99,Groceries,Nottingham,UK
1070,2021-12-10 00:00:00,BP,SAVE THE CHANGE,0.25,,1458.96,Savings,Nottingham,UK
1071,2021-11-10 00:00:00,DEB,REVOLUTION DE CUBA,8.75,,1459.21,Dine Out,Nottingham,UK
1072,2021-11-10 00:00:00,BP,SAVE THE CHANGE,2.99,,1467.96,Savings,Nottingham,UK
1073,2021-11-10 00:00:00,DEB,ORIENTAL MART HYDR,5.84,,1470.95,Groceries,Nottingham,UK
1074,2021-11-10 00:00:00,DEB,SUPERDRUG STORES P,3.9,,1476.79,Other Shopping,,
1075,2021-11-10 00:00:00,DEB,HARTLEYS SANDWICH,2.95,,1480.69,Dine Out,Leeds,UK
1076,2021-11-10 00:00:00,DEB,PRICKLY PEAR,12.5,,1483.64,Dine Out,Nottingham,UK
1077,2021-11-10 00:00:00,DEB,LIDL GB  NOTTINGHA,7.69,,1496.14,Groceries,Nottingham,UK
1078,2021-08-10 00:00:00,DEB,Amazon.co.uk*8T0UU,1.19,,1503.83,Amazon,Nottingham,UK
1079,2021-08-10 00:00:00,DEB,31K,12.0,,1505.02,Dine Out,Nottingham,UK
1080,2021-08-10 00:00:00,DEB,STARBUCKS,7.4,,1517.02,Dine Out,,
1081,2021-08-10 00:00:00,DEB,Subway 32610 Midla,6.89,,1524.42,Dine Out,Nottingham,UK
1082,2021-08-10 00:00:00,DEB,ATRIUM JUBILEE 1,2.65,,1531.31,Dine Out,Nottingham,UK
1083,2021-08-10 00:00:00,BP,SAVE THE CHANGE,2.3,,1533.96,Savings,Nottingham,UK
1084,2021-07-10 00:00:00,FPO,ANTIGONI ABRAHMS,6.0,,1536.26,Entertainment,London,UK
1085,2021-07-10 00:00:00,DEB,AMZNMktplace,19.99,,1542.26,Amazon,Nottingham,UK
1086,2021-07-10 00:00:00,DEB,LIDL GB  NOTTINGHA,11.11,,1562.25,Groceries,Nottingham,UK
1087,2021-07-10 00:00:00,DEB,AMZNMktplace,6.5,,1573.36,Amazon,Nottingham,UK
1088,2021-07-10 00:00:00,DEB,AMZNMktplace,5.1,,1579.86,Amazon,Nottingham,UK
1089,2021-07-10 00:00:00,BP,SAVE THE CHANGE,0.81,,1584.96,Savings,Nottingham,UK
1090,2021-06-10 00:00:00,DEB,Subway 32610 Midla,6.19,,1585.77,Dine Out,Nottingham,UK
1091,2021-06-10 00:00:00,BP,SAVE THE CHANGE,0.36,,1591.96,Savings,Nottingham,UK
1092,2021-05-10 00:00:00,DEB,AMZNMktplace,23.99,,1592.32,Amazon,Nottingham,UK
1093,2021-05-10 00:00:00,DEB,LIDL GB  NOTTINGHA,12.65,,1616.31,Groceries,Nottingham,UK
1094,2021-05-10 00:00:00,BP,SAVE THE CHANGE,1.72,,1628.96,Savings,Nottingham,UK
1095,2021-04-10 00:00:00,DEP,CLUB LLOYDS WAIVED,,3.0,1630.68,Supplementary Income,Nottingham,UK
1096,2021-04-10 00:00:00,PAY,CLUB LLOYDS FEE,3.0,,1627.68,Bills,Nottingham,UK
1097,2021-04-10 00:00:00,DEB,The Speciality Cof,22.2,,1630.68,Dine Out,Nottingham,UK
1098,2021-04-10 00:00:00,DEB,ORIENTAL MART HYDR,12.08,,1652.88,Groceries,Nottingham,UK
1099,2021-04-10 00:00:00,BP,SAVE THE CHANGE,2.02,,1664.96,Savings,Nottingham,UK
1100,2021-04-10 00:00:00,DEB,AMZNMktplace,22.84,,1666.98,Amazon,Nottingham,UK
1101,2021-04-10 00:00:00,DEB,SUMUP  *TODO LATIN,12.5,,1689.82,Entertainment,Nottingham,UK
1102,2021-04-10 00:00:00,DEB,U CANTEEN,10.5,,1702.32,Dine Out,Nottingham,UK
1103,2021-04-10 00:00:00,FPO,TRADING212UK,500.0,,1712.82,Investment,Nottingham,UK
1104,2021-01-10 00:00:00,,INTEREST (GROSS),,0.79,2212.82,Interest,Nottingham,UK
1105,2021-01-10 00:00:00,DEB,EB *SPEED DATING O,22.15,,2212.03,Entertainment,Nottingham,UK
1106,2021-01-10 00:00:00,DEB,AMZNMktplace,8.99,,2234.18,Amazon,Nottingham,UK
1107,2021-01-10 00:00:00,FPO,ABAYOMI ADAMS,370.0,,2243.17,Safety Deposit Return,Nottingham,UK
1108,2021-01-10 00:00:00,DD,BARCLAYS UK MTGES,981.71,,2613.17,Bills,Nottingham,UK
1109,2021-01-10 00:00:00,DD,NOTTM CITY COUNC,157.0,,3594.88,Bills,Nottingham,UK
1110,2021-01-10 00:00:00,DD,OCTOPUS ENERGY,90.0,,3751.88,Bills,Nottingham,UK
1111,2021-01-10 00:00:00,DD,SEVERN TRENT WATER,35.32,,3841.88,Bills,Nottingham,UK
1112,2021-01-10 00:00:00,SO,Q WANG,,1000.0,3877.2,Supplementary Income,Nottingham,UK
1113,2021-01-10 00:00:00,SO,ESAVINGS ACCOUNT,300.0,,2877.2,Savings,Nottingham,UK
1114,2021-01-10 00:00:00,BP,SAVE THE CHANGE,0.15,,3177.2,Savings,Nottingham,UK
1115,30/09/2021,FPO,ANTIGONI ABRAHMS,6.0,,3177.35,Entertainment,London,UK
1116,30/09/2021,DEB,AMZNMktplace,95.99,,3183.35,Amazon,Nottingham,UK
1117,30/09/2021,DEB,LIDL GB  NOTTINGHA,16.86,,3279.34,Groceries,Nottingham,UK
1118,30/09/2021,BP,SAVE THE CHANGE,0.81,,3296.2,Savings,Nottingham,UK
1119,29/09/2021,DEB,Subway 32610 Midla,6.19,,3297.01,Dine Out,Nottingham,UK
1120,29/09/2021,FPO,TRADING212UK,1500.0,,3303.2,Investment,Nottingham,UK
1121,29/09/2021,FPO,TAMBA TAM,10.0,,4803.2,Services,Nottingham,UK
1122,29/09/2021,BP,SAVE THE CHANGE,0.23,,4813.2,Savings,Nottingham,UK
1123,29/09/2021,BGC,UNIV OF NOTTINGHAM,,4091.83,4813.43,Paycheck,Nottingham,UK
1124,28/09/2021,DEB,AMZNMktplace,47.77,,721.6,Amazon,Nottingham,UK
1125,28/09/2021,BP,SAVE THE CHANGE,1.28,,769.37,Savings,Nottingham,UK
1126,27/09/2021,DEB,Amazon.co.uk*CM96E,22.27,,770.65,Amazon,Nottingham,UK
1127,27/09/2021,DEB,REVOLUTION DE CUBA,5.45,,792.92,Dine Out,Nottingham,UK
1128,27/09/2021,DEB,CAFFE NERO NOTTING,10.0,,798.37,Dine Out,Nottingham,UK
1129,27/09/2021,DD,TALKTALK LIMITED,21.0,,808.37,Bills,Nottingham,UK
1130,27/09/2021,BP,SAVE THE CHANGE,3.22,,829.37,Savings,Nottingham,UK
1131,27/09/2021,DEB,IKEA LTD SHOP ONLI,110.0,,832.59,Other Shopping,,
1132,27/09/2021,DEB,AMZNMktplace,18.99,,942.59,Amazon,Nottingham,UK
1133,27/09/2021,DEB,ORIENTAL MART HYDR,13.04,,961.58,Groceries,Nottingham,UK
1134,27/09/2021,DEB,IZ *BELLAPAELLA,7.0,,974.62,Dine Out,Nottingham,UK
1135,27/09/2021,DEB,LIDL GB  NOTTINGHA,6.32,,981.62,Groceries,Nottingham,UK
1136,27/09/2021,DEB,LIDL GB  NOTTINGHA,4.57,,987.94,Groceries,Nottingham,UK
1137,27/09/2021,DEB,AMZNMktplace,3.82,,992.51,Amazon,Nottingham,UK
1138,27/09/2021,FPO,TRADING212UK,400.0,,996.33,Investment,Nottingham,UK
1139,27/09/2021,FPI,PAULINA PIPPEN,,320.0,1396.33,Supplementary Income,Nottingham,UK
1140,24/09/2021,DEB,LIDL GB  NOTTINGHA,9.86,,1076.33,Groceries,Nottingham,UK
1141,24/09/2021,DEB,Audible UK,7.99,,1086.19,Entertainment,Nottingham,UK
1142,24/09/2021,DEB,Subway 32610 Midla,6.19,,1094.18,Dine Out,Nottingham,UK
1143,22/09/2021,BP,SAVE THE CHANGE,1.65,,1100.37,Savings,Nottingham,UK
1144,21/09/2021,FPO,TAMBA TAM,10.0,,1102.02,Services,Nottingham,UK
1145,21/09/2021,DEB,LIDL GB  NOTTINGHA,7.16,,1112.02,Groceries,Nottingham,UK
1146,21/09/2021,DEB,Subway 32610 Midla,6.19,,1119.18,Dine Out,Nottingham,UK
1147,21/09/2021,FPO,TRADING212UK,400.0,,1125.37,Investment,Nottingham,UK
1148,21/09/2021,BP,SAVE THE CHANGE,0.6,,1525.37,Savings,Nottingham,UK
1149,20/09/2021,FPI,SHEILA SMITH,,380.0,1525.97,Supplementary Income,Nottingham,UK
1150,20/09/2021,DEB,ESCOBAR,21.4,,1145.97,Dine Out,Nottingham,UK
1151,20/09/2021,BP,SAVE THE CHANGE,1.11,,1167.37,Savings,Nottingham,UK
1152,20/09/2021,DEB,AMZNMktplace,6.99,,1168.48,Amazon,Nottingham,UK
1153,20/09/2021,DEB,ORIENTAL MART HYDR,6.94,,1175.47,Groceries,Nottingham,UK
1154,20/09/2021,DEB,TESCO STORE 2960,3.1,,1182.41,Groceries,,
1155,20/09/2021,DEB,T K MAXX,2.99,,1185.51,Other Shopping,,
1156,20/09/2021,FPO,TRADING212UK,400.0,,1188.5,Investment,Nottingham,UK
1157,20/09/2021,DEB,AMZNMktplace,9.99,,1588.5,Amazon,Nottingham,UK
1158,17/09/2021,DEB,Subway 32610 Midla,6.89,,1598.49,Dine Out,Nottingham,UK
1159,17/09/2021,DEB,Subway 32610 Midla,3.99,,1605.38,Dine Out,Nottingham,UK
1160,17/09/2021,DD,VIRGIN MEDIA PYMTS,25.5,,1609.37,Bills,Nottingham,UK
1161,17/09/2021,BP,SAVE THE CHANGE,1.13,,1634.87,Savings,Nottingham,UK
1162,16/09/2021,FPO,ANTIGONI ABRAHMS,6.0,,1636.0,Entertainment,London,UK
1163,16/09/2021,DEB,AMZNMktplace,11.99,,1642.0,Amazon,Nottingham,UK
1164,16/09/2021,DEB,LIDL GB  NOTTINGHA,9.49,,1653.99,Groceries,Nottingham,UK
1165,16/09/2021,DEB,AMZNMKTPLACE AMAZO,6.39,,1663.48,Amazon,Nottingham,UK
1166,16/09/2021,DD,O2,16.66,,1669.87,Other Shopping,Nottingham,UK
1167,16/09/2021,BP,SAVE THE CHANGE,0.81,,1686.53,Savings,Nottingham,UK
1168,15/09/2021,DEB,Subway 32610 Midla,6.19,,1687.34,Dine Out,Nottingham,UK
1169,15/09/2021,BP,SAVE THE CHANGE,0.56,,1693.53,Savings,Nottingham,UK
1170,14/09/2021,FPO,TAMBA TAM,10.0,,1694.09,Services,Nottingham,UK
1171,14/09/2021,DEB,HPI INSTANT INK UK,3.49,,1704.09,Other Shopping,,
1172,14/09/2021,DEB,AMZNMktplace,14.99,,1707.58,Amazon,Nottingham,UK
1173,14/09/2021,DEB,LIDL GB  NOTTINGHA,7.96,,1722.57,Groceries,Nottingham,UK
1174,14/09/2021,BP,SAVE THE CHANGE,1.2,,1730.53,Savings,Nottingham,UK
1175,13/09/2021,DEB,AMZNMKTPLACE AMAZO,15.9,,1731.73,Amazon,Nottingham,UK
1176,13/09/2021,DEB,CAFE CHHINO,7.95,,1747.63,Dine Out,Nottingham,UK
1177,13/09/2021,DEB,REVOLUTION DE CUBA,5.5,,1755.58,Dine Out,Nottingham,UK
1178,13/09/2021,DEB,REVOLUTION DE CUBA,5.45,,1761.08,Dine Out,Nottingham,UK
1179,13/09/2021,BP,SAVE THE CHANGE,1.38,,1766.53,Savings,Nottingham,UK
1180,13/09/2021,DEB,ORIENTAL MART HYDR,6.75,,1767.91,Groceries,Nottingham,UK
1181,13/09/2021,DEB,LIDL GB  NOTTINGHA,8.3,,1774.66,Groceries,Nottingham,UK
1182,2021-10-09 00:00:00,DEB,LIDL GB  NOTTINGHA,14.68,,1782.96,Groceries,Nottingham,UK
1183,2021-10-09 00:00:00,DEB,Subway 32610 Midla,6.89,,1797.64,Dine Out,Nottingham,UK
1184,2021-10-09 00:00:00,BP,SAVE THE CHANGE,0.12,,1804.53,Savings,Nottingham,UK
1185,2021-09-09 00:00:00,DEB,AMZNMktplace,10.99,,1804.65,Amazon,Nottingham,UK
1186,2021-09-09 00:00:00,DEB,IKEA LTD SHOP ONLI,55.0,,1815.64,Other Shopping,,
1187,2021-09-09 00:00:00,DEB,AMZNMktplace,14.89,,1870.64,Amazon,Nottingham,UK
1188,2021-09-09 00:00:00,FPI,PAULINA PIPPEN,,320.0,1885.53,Supplementary Income,Nottingham,UK
1189,2021-09-09 00:00:00,BP,SAVE THE CHANGE,0.02,,1565.53,Savings,Nottingham,UK
1190,2021-08-09 00:00:00,DEB,Subway 32610 Midla,5.99,,1565.55,Dine Out,Nottingham,UK
1191,2021-08-09 00:00:00,DEB,AMZNMktplace,3.99,,1571.54,Amazon,Nottingham,UK
1192,2021-08-09 00:00:00,TFR,R LAWRENCE,,500.0,1575.53,Supplementary Income,Nottingham,UK
1193,2021-08-09 00:00:00,FPO,MR J LITCHFIELD,544.84,,1075.53,Services,Nottingham,UK
1194,2021-08-09 00:00:00,FPO,TAMBA TAM,10.0,,1620.37,Services,Nottingham,UK
1195,2021-08-09 00:00:00,BP,SAVE THE CHANGE,0.46,,1630.37,Savings,Nottingham,UK
1196,2021-07-09 00:00:00,DEB,LIDL GB  NOTTINGHA,9.54,,1630.83,Groceries,Nottingham,UK
1197,2021-07-09 00:00:00,BP,SAVE THE CHANGE,0.65,,1640.37,Savings,Nottingham,UK
1198,2021-06-09 00:00:00,DEB,SUMUP  *TODO LATIN,15.0,,1641.02,Entertainment,Nottingham,UK
1199,2021-06-09 00:00:00,DEB,REVOLUTION DE CUBA,5.35,,1656.02,Dine Out,Nottingham,UK
1200,2021-06-09 00:00:00,DD,PURE GYM LTD,19.99,,1661.37,Fitness,Nottingham,UK
1201,2021-06-09 00:00:00,BP,SAVE THE CHANGE,2.8,,1681.36,Savings,Nottingham,UK
1202,2021-06-09 00:00:00,DEB,ORIENTAL MART HYDR,6.99,,1684.16,Groceries,Nottingham,UK
1203,2021-06-09 00:00:00,DEB,Amazon.co.uk*RJ1R7,32.21,,1691.15,Amazon,Nottingham,UK
1204,2021-06-09 00:00:00,DEB,LIDL GB  NOTTINGHA,7.96,,1723.36,Groceries,Nottingham,UK
1205,2021-03-09 00:00:00,DEB,No. Twelve,66.53,,1731.32,Dine Out,Nottingham,UK
1206,2021-03-09 00:00:00,DEB,LIDL GB NOTTINGHAM,9.02,,1797.85,Groceries,Nottingham,UK
1207,2021-03-09 00:00:00,DEB,Subway 32610 Midla,6.49,,1806.87,Dine Out,Nottingham,UK
1208,2021-03-09 00:00:00,BP,SAVE THE CHANGE,0.46,,1813.36,Savings,Nottingham,UK
1209,2021-02-09 00:00:00,DEP,CLUB LLOYDS WAIVED,,3.0,1813.82,Supplementary Income,Nottingham,UK
1210,2021-02-09 00:00:00,FPO,ANTIGONI ABRAHMS,6.0,,1810.82,Entertainment,London,UK
1211,2021-02-09 00:00:00,PAY,CLUB LLOYDS FEE,3.0,,1816.82,Bills,Nottingham,UK
1212,2021-02-09 00:00:00,DEB,SUMUP  *TODO LATIN,15.0,,1819.82,Entertainment,Nottingham,UK
1213,2021-02-09 00:00:00,DEB,AMZNMktplace,8.99,,1834.82,Amazon,Nottingham,UK
1214,2021-02-09 00:00:00,DEB,REVOLUTION DE CUBA,4.55,,1843.81,Dine Out,Nottingham,UK
1215,2021-02-09 00:00:00,BP,SAVE THE CHANGE,0.15,,1848.36,Savings,Nottingham,UK
1216,2021-01-09 00:00:00,,INTEREST (GROSS),,0.87,1848.51,Interest,Nottingham,UK
1217,2021-01-09 00:00:00,CPT,LNK TESCO HK R NOT,30.0,,1847.64,Cash,nottingham,UK
1218,2021-01-09 00:00:00,DEB,SHARIF AND SONS SU,23.88,,1877.64,Groceries,Derby,UK
1219,2021-01-09 00:00:00,DEB,Amazon.co.uk*XS1VA,11.97,,1901.52,Amazon,Nottingham,UK
1220,2021-01-09 00:00:00,FPO,TRADING212UK,500.0,,1913.49,Investment,Nottingham,UK
1221,2021-01-09 00:00:00,FPO,TRADING212UK,100.0,,2413.49,Investment,Nottingham,UK
1222,2021-01-09 00:00:00,TFR,R LAWRENCE,,200.0,2513.49,Supplementary Income,Nottingham,UK
1223,2021-01-09 00:00:00,DD,BARCLAYS UK MTGES,981.71,,2313.49,Bills,Nottingham,UK
1224,2021-01-09 00:00:00,DD,NOTTM CITY COUNC,157.0,,3295.2,Bills,Nottingham,UK
1225,2021-01-09 00:00:00,DD,OCTOPUS ENERGY,90.0,,3452.2,Bills,Nottingham,UK
1226,2021-01-09 00:00:00,DD,SEVERN TRENT WATER,35.32,,3542.2,Bills,Nottingham,UK
1227,2021-01-09 00:00:00,SO,Q WANG,,1000.0,3577.52,Supplementary Income,Nottingham,UK
1228,2021-01-09 00:00:00,SO,ESAVINGS ACCOUNT,300.0,,2577.52,Savings,Nottingham,UK
1229,31/08/2021,BP,SAVE THE CHANGE,1.4,,2877.52,Savings,Nottingham,UK
1230,31/08/2021,DEB,SAINSBURYS S/MKTS,34.18,,2878.92,Groceries,,
1231,31/08/2021,DEB,ANATOLIA TURKISH R,12.0,,2913.1,Dine Out,Nottingham,UK
1232,31/08/2021,DEB,LIDL GB  NOTTINGHA,13.42,,2925.1,Groceries,Nottingham,UK
1233,27/08/2021,CPT,LNK TESCO HK R NOT,40.0,,2938.52,Cash,nottingham,UK
1234,27/08/2021,FPO,TRADING212UK,1500.0,,2978.52,Investment,Nottingham,UK
1235,27/08/2021,DD,TALKTALK LIMITED,21.0,,4478.52,Bills,Nottingham,UK
1236,27/08/2021,BGC,UNIV OF NOTTINGHAM,,3801.43,4499.52,Paycheck,Nottingham,UK
1237,26/08/2021,FPO,ANTIGONI ABRAHMS,6.0,,698.09,Entertainment,London,UK
1238,26/08/2021,BP,SAVE THE CHANGE,0.81,,704.09,Savings,Nottingham,UK
1239,25/08/2021,DEB,T4 TEA SALOON,14.2,,704.9,Dine Out,Nottingham,UK
1240,25/08/2021,DEB,AMZNMktplace,9.99,,719.1,Amazon,Nottingham,UK
1241,25/08/2021,FPO,TRADING212UK,300.0,,729.09,Investment,Nottingham,UK
1242,25/08/2021,FPI,ABAYOMI ADAMS,,400.0,1029.09,Supplementary Income,Nottingham,UK
1243,25/08/2021,BP,SAVE THE CHANGE,0.06,,629.09,Savings,Nottingham,UK
1244,24/08/2021,FPO,TAMBA TAM,10.0,,629.15,Services,Nottingham,UK
1245,24/08/2021,DEB,AMZNMktplace,18.95,,639.15,Amazon,Nottingham,UK
1246,24/08/2021,DEB,Audible UK,7.99,,658.1,Entertainment,Nottingham,UK
1247,24/08/2021,FPO,TRADING212UK,300.0,,666.09,Investment,Nottingham,UK
1248,24/08/2021,BP,SAVE THE CHANGE,0.21,,966.09,Savings,Nottingham,UK
1249,23/08/2021,DEB,LIDL GB  NOTTINGHA,15.79,,966.3,Groceries,Nottingham,UK
1250,23/08/2021,DEB,Amazon.co.uk*I0899,12.0,,982.09,Amazon,Nottingham,UK
1251,23/08/2021,BP,SAVE THE CHANGE,2.54,,994.09,Savings,Nottingham,UK
1252,23/08/2021,DEB,T K MAXX,21.94,,996.63,Other Shopping,,
1253,23/08/2021,DEB,ORIENTAL MART HYDR,11.17,,1018.57,Groceries,Nottingham,UK
1254,23/08/2021,DEB,AMZNMktplace,5.99,,1029.74,Amazon,Nottingham,UK
1255,23/08/2021,DEB,LIDL GB  NOTTINGHA,16.09,,1035.73,Groceries,Nottingham,UK
1256,23/08/2021,DEB,AMZNMktplace,11.27,,1051.82,Amazon,Nottingham,UK
1257,20/08/2021,FPO,TRADING212UK,300.0,,1063.09,Investment,Nottingham,UK
1258,20/08/2021,FPI,SHEILA SMITH,,380.0,1363.09,Supplementary Income,Nottingham,UK
1259,20/08/2021,BP,SAVE THE CHANGE,1.01,,983.09,Savings,Nottingham,UK
1260,19/08/2021,DEB,AMZNMktplace,18.5,,984.1,Amazon,Nottingham,UK
1261,19/08/2021,DEB,HPI INSTANT INK UK,3.49,,1002.6,Other Shopping,,
1262,18/08/2021,FPO,TRADING212UK,400.0,,1006.09,Investment,Nottingham,UK
1263,18/08/2021,BP,SAVE THE CHANGE,0.14,,1406.09,Savings,Nottingham,UK
1264,17/08/2021,DEB,LIDL GB  NOTTINGHA,5.86,,1406.23,Groceries,Nottingham,UK
1265,17/08/2021,DD,VIRGIN MEDIA PYMTS,25.5,,1412.09,Bills,Nottingham,UK
1266,16/08/2021,FPO,TRADING212UK,500.0,,1437.59,Investment,Nottingham,UK
1267,16/08/2021,DD,O2,16.66,,1937.59,Other Shopping,Nottingham,UK
1268,16/08/2021,BP,SAVE THE CHANGE,0.06,,1954.25,Savings,Nottingham,UK
1269,16/08/2021,DEB,AMZNMktplace,5.94,,1954.31,Amazon,Nottingham,UK
1270,2021-11-08 00:00:00,BP,SAVE THE CHANGE,0.1,,1960.25,Savings,Nottingham,UK
1271,2021-10-08 00:00:00,DEB,Amazon.co.uk*BV22U,7.9,,1960.35,Amazon,Nottingham,UK
1272,2021-10-08 00:00:00,BP,SAVE THE CHANGE,0.6,,1968.25,Savings,Nottingham,UK
1273,2021-09-08 00:00:00,DEB,Amazon.co.uk*VM9GG,14.4,,1968.85,Amazon,Nottingham,UK
1274,2021-09-08 00:00:00,BP,SAVE THE CHANGE,0.02,,1983.25,Savings,Nottingham,UK
1275,2021-06-08 00:00:00,DEB,AMZNMktplace,15.99,,1983.27,Amazon,Nottingham,UK
1276,2021-06-08 00:00:00,DEB,AMZNMktplace,15.99,,1999.26,Amazon,Nottingham,UK
1277,2021-06-08 00:00:00,DD,PURE GYM LTD,19.99,,2015.25,Fitness,Nottingham,UK
1278,2021-05-08 00:00:00,BP,SAVE THE CHANGE,0.21,,2035.24,Savings,Nottingham,UK
1279,2021-04-08 00:00:00,DEB,Amazon.co.uk*W99XU,25.8,,2035.45,Amazon,Nottingham,UK
1280,2021-04-08 00:00:00,DEB,AMZNMktplace,9.99,,2061.25,Amazon,Nottingham,UK
1281,2021-04-08 00:00:00,FPO,TRADING212UK,100.0,,2071.24,Investment,Nottingham,UK
1282,2021-04-08 00:00:00,BP,SAVE THE CHANGE,1.08,,2171.24,Savings,Nottingham,UK
1283,2021-03-08 00:00:00,DEP,CLUB LLOYDS WAIVED,,3.0,2172.32,Amazon,Nottingham,UK
1284,2021-03-08 00:00:00,PAY,CLUB LLOYDS FEE,3.0,,2169.32,Bills,Nottingham,UK
1285,2021-03-08 00:00:00,DEB,AMZNMktplace,20.99,,2172.32,Supplementary Income,Nottingham,UK
1286,2021-03-08 00:00:00,DEB,AMZNMktplace,14.44,,2193.31,Amazon,Nottingham,UK
1287,2021-03-08 00:00:00,DEB,AMZNMktplace,8.49,,2207.75,Amazon,Nottingham,UK
1288,2021-03-08 00:00:00,TFR,R LAWRENCE,,150.0,2216.24,Supplementary Income,Nottingham,UK
1289,2021-02-08 00:00:00,,INTEREST (GROSS),,0.8,2066.24,Interest,Nottingham,UK
1290,2021-02-08 00:00:00,FPO,TRADING212UK,500.0,,2065.44,Investment,Nottingham,UK
1291,2021-02-08 00:00:00,DD,BARCLAYS UK MTGES,981.71,,2565.44,Bills,Nottingham,UK
1292,2021-02-08 00:00:00,DD,NOTTM CITY COUNC,157.0,,3547.15,Bills,Nottingham,UK
1293,2021-02-08 00:00:00,DD,OCTOPUS ENERGY,90.0,,3704.15,Bills,Nottingham,UK
1294,2021-02-08 00:00:00,DD,SEVERN TRENT WATER,35.32,,3794.15,Bills,Nottingham,UK
1295,2021-02-08 00:00:00,SO,Q WANG,,1000.0,3829.47,Supplementary Income,Nottingham,UK
1296,2021-02-08 00:00:00,SO,ESAVINGS ACCOUNT,300.0,,2829.47,Savings,Nottingham,UK
1297,30/07/2021,FPO,TRADING212UK,1000.0,,3129.47,Investment,Nottingham,UK
1298,29/07/2021,BP,SAVE THE CHANGE,1.19,,4129.47,Savings,Nottingham,UK
1299,29/07/2021,BGC,UNIV OF NOTTINGHAM,,3756.19,4130.66,Paycheck,Nottingham,UK
1300,28/07/2021,DEB,AMZNMktplace,117.79,,374.47,Amazon,Nottingham,UK
1301,28/07/2021,DEB,LIDL GB  NOTTINGHA,14.02,,492.26,Groceries,Nottingham,UK
1302,28/07/2021,BP,SAVE THE CHANGE,0.66,,506.28,Savings,Nottingham,UK
1303,28/07/2021,FPO,TAMBA TAM,10.0,,506.94,Services,Nottingham,UK
1304,27/07/2021,DEB,UNION ROOMS,4.34,,516.94,Dine Out,Plymouth/Newcatle,UK
1305,27/07/2021,DEB,CRYSTAL DRAGON,12.0,,521.28,Other Shopping,Plymouth,UK
1306,27/07/2021,FPO,TRADING212UK,400.0,,533.28,Investment,Nottingham,UK
1307,27/07/2021,DD,TALKTALK LIMITED,20.84,,933.28,Bills,Nottingham,UK
1308,27/07/2021,BP,SAVE THE CHANGE,1.82,,954.12,Savings,Nottingham,UK
1309,26/07/2021,DEB,TIGERMILK EVENTS,9.5,,955.94,Entertainment,Plymouth,UK
1310,26/07/2021,DEB,UNION ROOMS,4.34,,965.44,Dine Out,Plymouth/Newcatle,UK
1311,26/07/2021,DEB,UNION ROOMS,4.34,,969.78,Dine Out,Plymouth/Newcatle,UK
1312,26/07/2021,FPI,ABAYOMI ADAMS,,400.0,974.12,Supplementary Income,Nottingham,UK
1313,26/07/2021,BP,SAVE THE CHANGE,2.51,,574.12,Savings,Nottingham,UK
1314,26/07/2021,DEB,SKECHERS PLYMOUTH,67.0,,576.63,Other Shopping,Plymouth,UK
1315,26/07/2021,DEB,THE RISE BAKERY,14.75,,643.63,Dine Out,Plymouth,UK
1316,26/07/2021,CPT,LNK BOOZE BUSTERS,50.0,,658.38,Cash,Nottingham,UK
1317,26/07/2021,DEB,THE RISE BAKERY,11.15,,708.38,Dine Out,Plymouth,UK
1318,26/07/2021,DEB,Audible UK,7.99,,719.53,Entertainment,Nottingham,UK
1319,26/07/2021,DEB,PASTIES 4 YOU LTD,2.5,,727.52,Dine Out,Sheffild ,UK
1320,26/07/2021,DEB,CAFFE NERO BIRMING,3.6,,730.02,Dine Out,Birmingham,UK
1321,23/07/2021,DEB,THE NEW CONTINENTA,465.0,,733.62,Dine Out,Bargoed,UK
1322,23/07/2021,DEB,EAST MIDS RAILWAY,155.5,,1198.62,Travel,Nottingham,UK
1323,23/07/2021,BP,SAVE THE CHANGE,0.01,,1354.12,Savings,Nottingham,UK
1324,23/07/2021,BGC,OPEN UNIVERSITY,,372.32,1354.13,Supplementary Income,Nottingham,UK
1325,22/07/2021,DEB,AMZNMktplace,12.99,,981.81,Amazon,Nottingham,UK
1326,22/07/2021,BP,SAVE THE CHANGE,0.83,,994.8,Savings,Nottingham,UK
1327,21/07/2021,DEB,AMZNMktplace,12.99,,995.63,Amazon,Nottingham,UK
1328,21/07/2021,DEB,LIDL GB NOTTINGHAM,8.94,,1008.62,Groceries,Nottingham,UK
1329,21/07/2021,DEB,Amazon.co.uk*228N1,5.24,,1017.56,Amazon,Nottingham,UK
1330,21/07/2021,FPO,TRADING212UK,200.0,,1022.8,Bills,Nottingham,UK
1331,21/07/2021,BP,SAVE THE CHANGE,0.08,,1222.8,Savings,Nottingham,UK
1332,20/07/2021,FPO,TAMBA TAM,10.0,,1222.88,Services,Nottingham,UK
1333,20/07/2021,FPI,SHEILA SMITH,,380.0,1232.88,Supplementary Income,Nottingham,UK
1334,20/07/2021,DEB,AMZNMktplace,102.94,,852.88,Amazon,Nottingham,UK
1335,20/07/2021,DEB,AMZNMktplace,12.99,,955.82,Amazon,Nottingham,UK
1336,20/07/2021,DEB,Amazon.co.uk*1D3K4,4.99,,968.81,Amazon,Nottingham,UK
1337,20/07/2021,BP,SAVE THE CHANGE,2.05,,973.8,Savings,Nottingham,UK
1338,19/07/2021,DEB,SAINSBURYS S/MKTS,21.55,,975.85,Groceries,,
1339,19/07/2021,DEB,AMZNMktplace,11.11,,997.4,Amazon,Nottingham,UK
1340,19/07/2021,DEB,AMZNMktplace,8.75,,1008.51,Amazon,Nottingham,UK
1341,19/07/2021,DEB,AMZNMktplace,5.54,,1017.26,Amazon,Nottingham,UK
1342,19/07/2021,DD,VIRGIN MEDIA PYMTS,25.5,,1022.8,Investment,Nottingham,UK
1343,19/07/2021,BP,SAVE THE CHANGE,0.96,,1048.3,Savings,Nottingham,UK
1344,19/07/2021,FPO,TRADING212UK,150.0,,1049.26,Investment,Nottingham,UK
1345,19/07/2021,DEB,LIDL GB  NOTTINGHA,15.44,,1199.26,Groceries,Nottingham,UK
1346,19/07/2021,DEB,Audible UK,18.0,,1214.7,Entertainment,Nottingham,UK
1347,19/07/2021,DEB,SQ *DIVINE COFFEE,9.6,,1232.7,Dine Out,Nottingham ,UK
1348,16/07/2021,DEB,TESCO STORES 6735,2.0,,1242.3,Groceries,,
1349,16/07/2021,DD,O2,16.66,,1244.3,Other Shopping,Nottingham,UK
1350,15/07/2021,FPO,ANTIGONI ABRAHMS,6.0,,1260.96,Entertainment,London,UK
1351,15/07/2021,FPO,ALICJA ALEXANDER,30.0,,1266.96,Services/Home Improvement,Nottingham,UK
1352,15/07/2021,BP,SAVE THE CHANGE,1.08,,1296.96,Savings,Nottingham,UK
1353,14/07/2021,DEB,HPI INSTANT INK UK,3.49,,1298.04,Other Shopping,,
1354,14/07/2021,DEB,LIDL GB NOTTINGHAM,11.44,,1301.53,Groceries,Nottingham,UK
1355,14/07/2021,DEB,AMZNMktplace,8.99,,1312.97,Amazon,Nottingham,UK
1356,13/07/2021,FPO,TAMBA TAM,10.0,,1321.96,Services,Nottingham,UK
1357,13/07/2021,BP,SAVE THE CHANGE,0.51,,1331.96,Savings,Nottingham,UK
1358,2021-12-07 00:00:00,DEB,GOOGLE *YouTube Vi,3.49,,1332.47,,Nottingham,UK
1359,2021-12-07 00:00:00,BP,SAVE THE CHANGE,2.12,,1335.96,Savings,Nottingham,UK
1360,2021-12-07 00:00:00,DEB,AMZNMktplace,9.34,,1338.08,Amazon,Nottingham,UK
1361,2021-12-07 00:00:00,DEB,WILKO RETAIL LIMIT,3.5,,1347.42,Other Shopping,,
1362,2021-12-07 00:00:00,DEB,ORIENTAL MART HYDR,3.26,,1350.92,Groceries,Nottingham,UK
1363,2021-12-07 00:00:00,DEB,AMZNMKTPLACE AMAZO,25.99,,1354.18,Amazon,Nottingham,UK
1364,2021-12-07 00:00:00,FPO,ROBERT RECORD,30.0,,1380.17,Others,Nottingham,UK
1365,2021-12-07 00:00:00,DEB,SAINSBURYS S/MKTS,35.8,,1410.17,Groceries,,
1366,2021-09-07 00:00:00,DEB,31K,12.0,,1445.97,Dine Out,Nottingham,UK
1367,2021-09-07 00:00:00,DEB,AMZNMKTPLACE AMAZO,11.99,,1457.97,Amazon,Nottingham,UK
1368,2021-09-07 00:00:00,BP,SAVE THE CHANGE,0.8,,1469.96,Savings,Nottingham,UK
1369,2021-08-07 00:00:00,FPO,ANTIGONI ABRAHMS,6.0,,1470.76,Entertainment,London,UK
1370,2021-08-07 00:00:00,DEB,RAJAH FOOD STORE L,6.2,,1476.76,Groceries,Nottingham,UK
1371,2021-08-07 00:00:00,BP,SAVE THE CHANGE,0.88,,1482.96,Savings,Nottingham,UK
1372,2021-07-07 00:00:00,DEB,TROPICAL SUMMER FE,114.57,,1483.84,Entertainment,Plymouth,UK
1373,2021-07-07 00:00:00,DEB,AMZNMktplace,98.55,,1598.41,Amazon,Nottingham,UK
1374,2021-07-07 00:00:00,BP,SAVE THE CHANGE,0.85,,1696.96,Savings,Nottingham,UK
1375,2021-06-07 00:00:00,FPO,TAMBA TAM,10.0,,1697.81,Services,Nottingham,UK
1376,2021-06-07 00:00:00,DEB,LIDL GB  NOTTINGHA,5.15,,1707.81,Groceries,Nottingham,UK
1377,2021-06-07 00:00:00,DD,PURE GYM LTD,19.99,,1712.96,Fitness,Nottingham,UK
1378,2021-06-07 00:00:00,BP,SAVE THE CHANGE,0.2,,1732.95,Savings,Nottingham,UK
1379,2021-05-07 00:00:00,DEB,LIDL GB  NOTTINGHA,11.8,,1733.15,Groceries,Nottingham,UK
1380,2021-05-07 00:00:00,BP,SAVE THE CHANGE,2.11,,1744.95,Savings,Nottingham,UK
1381,2021-05-07 00:00:00,DEB,Lush UK,36.0,,1747.06,Other Shopping,,
1382,2021-05-07 00:00:00,DEB,ORIENTAL MART HYDR,11.01,,1783.06,Groceries,Nottingham,UK
1383,2021-05-07 00:00:00,DEB,DOUGHNOTTS BAKERY,6.5,,1794.07,Dine Out,Nottingham,UK
1384,2021-05-07 00:00:00,DEB,LIDL GB  NOTTINGHA,18.39,,1800.57,Groceries,Nottingham,UK
1385,2021-02-07 00:00:00,DEP,CLUB LLOYDS WAIVED,,3.0,1818.96,Amazon,Nottingham,UK
1386,2021-02-07 00:00:00,PAY,CLUB LLOYDS FEE,3.0,,1815.96,Bills,Nottingham,UK
1387,2021-02-07 00:00:00,DEB,AMZNMktplace,14.99,,1818.96,Supplementary Income,Nottingham,UK
1388,2021-02-07 00:00:00,DEB,31K,12.0,,1833.95,Dine Out,Nottingham,UK
1389,2021-01-07 00:00:00,,INTEREST (GROSS),,0.63,1845.95,Interest,Nottingham,UK
1390,2021-01-07 00:00:00,FPO,ALICJA ALEXANDER,30.0,,1845.32,Services/Home Improvement,Nottingham,UK
1391,2021-01-07 00:00:00,FPO,ANTIGONI ABRAHMS,6.0,,1875.32,Entertainment,London,UK
1392,2021-01-07 00:00:00,FPO,TRADING212UK,500.0,,1881.32,Investment,Nottingham,UK
1393,2021-01-07 00:00:00,DD,BARCLAYS UK MTGES,981.71,,2381.32,Bills,Nottingham,UK
1394,2021-01-07 00:00:00,DD,NOTTM CITY COUNC,157.0,,3363.03,Bills,Nottingham,UK
1395,2021-01-07 00:00:00,DD,OCTOPUS ENERGY,90.0,,3520.03,Bills,Nottingham,UK
1396,2021-01-07 00:00:00,DD,SEVERN TRENT WATER,35.22,,3610.03,Bills,Nottingham,UK
1397,2021-01-07 00:00:00,SO,Q WANG,,1000.0,3645.25,Supplementary Income,Nottingham,UK
1398,2021-01-07 00:00:00,SO,ESAVINGS ACCOUNT,300.0,,2645.25,Savings,Nottingham,UK
1399,2021-01-07 00:00:00,BP,SAVE THE CHANGE,0.31,,2945.25,Savings,Nottingham,UK
1400,30/06/2021,DEB,LIDL GB NOTTINGHAM,10.69,,2945.56,Groceries,Nottingham,UK
1401,29/06/2021,FPO,TRADING212UK,1100.0,,2956.25,Investment,Nottingham,UK
1402,29/06/2021,BP,SAVE THE CHANGE,0.12,,4056.25,Savings,Nottingham,UK
1403,29/06/2021,BGC,UNIV OF NOTTINGHAM,,3756.18,4056.37,Paycheck,Nottingham,UK
1404,28/06/2021,DEB,Amazon.co.uk*200PY,29.99,,300.19,Amazon,Nottingham,UK
1405,28/06/2021,DEB,LIDL GB  NOTTINGHA,14.89,,330.18,Groceries,Nottingham,UK
1406,28/06/2021,FPO,JOE SPENCE,26.0,,345.07,Services,Nottingham,UK
1407,28/06/2021,BP,SAVE THE CHANGE,2.14,,371.07,Savings,Nottingham,UK
1408,28/06/2021,DEB,ORIENTAL MART HYDR,11.21,,373.21,Groceries,Nottingham,UK
1409,28/06/2021,DEB,AMZNMktplace,7.49,,384.42,Amazon,Nottingham,UK
1410,28/06/2021,FPO,ROBERT RECORD,120.0,,391.91,Others,Nottingham,UK
1411,28/06/2021,DEB,AMZNMktplace,39.98,,511.91,Amazon,Nottingham,UK
1412,25/06/2021,DEB,STARBUCKS,8.18,,551.89,Dine Out,,
1413,25/06/2021,DD,TALKTALK LIMITED,21.95,,560.07,Bills,Nottingham,UK
1414,25/06/2021,BP,SAVE THE CHANGE,1.37,,582.02,Savings,Nottingham,UK
1415,24/06/2021,FPO,ANTIGONI ABRAHMS,6.0,,583.39,Entertainment,London,UK
1416,24/06/2021,DEB,Amazon.co.uk*284VM,39.99,,589.39,Amazon,Nottingham,UK
1417,24/06/2021,DEB,LIDL GB  NOTTINGHA,15.06,,629.38,Groceries,Nottingham,UK
1418,24/06/2021,DEB,AMZNMktplace,9.59,,644.44,Amazon,Nottingham,UK
1419,24/06/2021,DEB,Audible UK,7.99,,654.03,Entertainment,Nottingham,UK
1420,24/06/2021,FPO,TRADING212UK,300.0,,662.02,Investment,Nottingham,UK
1421,24/06/2021,FPI,ABAYOMI ADAMS,,400.0,962.02,Supplementary Income,Nottingham,UK
1422,24/06/2021,BP,SAVE THE CHANGE,1.08,,562.02,Savings,Nottingham,UK
1423,23/06/2021,DEB,AMZNMktplace,22.33,,563.1,Amazon,Nottingham,UK
1424,23/06/2021,DEB,STARBUCKS,4.59,,585.43,Dine Out,,
1425,23/06/2021,FPO,TRADING212UK,100.0,,590.02,Investment,Nottingham,UK
1426,23/06/2021,FPO,RAC ELECTRICAL CON,150.0,,690.02,Home Improvement,Nottingham,UK
1427,23/06/2021,BP,SAVE THE CHANGE,1.02,,840.02,Savings,Nottingham,UK
1428,22/06/2021,DEB,AMZNMktplace,40.08,,841.04,Amazon,Nottingham,UK
1429,22/06/2021,DEB,AMZNMktplace,11.9,,881.12,Amazon,Nottingham,UK
1430,22/06/2021,BP,SAVE THE CHANGE,0.49,,893.02,Savings,Nottingham,UK
1431,21/06/2021,DEB,AMZNMktplace,9.99,,893.51,Amazon,Nottingham,UK
1432,21/06/2021,DEB,LIDL GB  NOTTINGHA,9.52,,903.5,Groceries,Nottingham,UK
1433,21/06/2021,FPO,TRADING212UK,200.0,,913.02,Investment,Nottingham,UK
1434,21/06/2021,BP,SAVE THE CHANGE,2.95,,1113.02,Savings,Nottingham,UK
1435,21/06/2021,FPI,SHEILA SMITH,,380.0,1115.97,Supplementary Income,Nottingham,UK
1436,21/06/2021,DEB,AMZNMktplace,21.89,,735.97,Amazon,Nottingham,UK
1437,21/06/2021,DEB,AMZNMktplace,19.95,,757.86,Amazon,Nottingham,UK
1438,21/06/2021,DEB,ORIENTAL MART HYDR,10.37,,777.81,Groceries,Nottingham,UK
1439,21/06/2021,DEB,DOUGHNOTTS BAKERY,5.5,,788.18,Dine Out,Nottingham,UK
1440,21/06/2021,DEB,WILKO RETAIL LIMIT,2.5,,793.68,Other Shopping,,
1441,21/06/2021,DEB,LIDL GB NOTTINGHAM,8.25,,796.18,Groceries,Nottingham,UK
1442,21/06/2021,DEB,STARBUCKS,4.59,,804.43,Dine Out,,
1443,18/06/2021,DEB,YOLK.,12.0,,809.02,Dine Out,Nottingham,UK
1444,18/06/2021,BP,SAVE THE CHANGE,0.3,,821.02,Savings,Nottingham,UK
1445,17/06/2021,FPO,ALICJA ALEXANDER,30.0,,821.32,Services/Home Improvement,Nottingham,UK
1446,17/06/2021,FPO,ANTIGONI ABRAHMS,6.0,,851.32,Entertainment,London,UK
1447,17/06/2021,DEB,AMZNMktplace,13.99,,857.32,Amazon,Nottingham,UK
1448,17/06/2021,DEB,LIDL GB  NOTTINGHA,6.71,,871.31,Groceries,Nottingham,UK
1449,17/06/2021,DD,VIRGIN MEDIA PYMTS,25.5,,878.02,Bills,Nottingham,UK
1450,17/06/2021,BP,SAVE THE CHANGE,0.66,,903.52,Savings,Nottingham,UK
1451,16/06/2021,DEB,AMZNMktplace,160.76,,904.18,Amazon,Nottingham,UK
1452,16/06/2021,DEB,AMZNMKTPLACE AMAZO,21.99,,1064.94,Amazon,Nottingham,UK
1453,16/06/2021,DEB,STARBUCKS,4.59,,1086.93,Dine Out,,
1454,16/06/2021,DD,O2,19.86,,1091.52,Other Shopping,Nottingham,UK
1455,16/06/2021,BP,SAVE THE CHANGE,1.87,,1111.38,Savings,Nottingham,UK
1456,15/06/2021,DEB,AMZNMktplace,33.0,,1113.25,Amazon,Nottingham,UK
1457,15/06/2021,DEB,SHARIF AND SONS SU,26.82,,1146.25,Groceries,Derby,UK
1458,15/06/2021,DEB,SOLO GRANO,16.01,,1173.07,Dine Out,Nottingham,UK
1459,15/06/2021,DEB,AMZNMktplace,4.79,,1189.08,Amazon,Nottingham,UK
1460,15/06/2021,DEB,AMZNMktplace,3.51,,1193.87,Amazon,Nottingham,UK
1461,15/06/2021,FPO,STEWART SCHOFIELD,150.0,,1197.38,Services,Nottingham,UK
1462,15/06/2021,BP,SAVE THE CHANGE,0.73,,1347.38,Savings,Nottingham,UK
1463,14/06/2021,DEB,LIDL GB  NOTTINGHA,14.79,,1348.11,Groceries,Nottingham,UK
1464,14/06/2021,DEB,HPI INSTANT INK UK,4.49,,1362.9,Other Shopping,,
1465,14/06/2021,DEB,ZARA NOTTINGHAM,19.99,,1367.39,Clothes,Nottingham,UK
1466,14/06/2021,BP,SAVE THE CHANGE,2.04,,1387.38,Savings,Nottingham,UK
1467,14/06/2021,DEB,ORIENTAL MART HYDR,11.17,,1389.42,Groceries,Nottingham,UK
1468,14/06/2021,DEB,DOUGHNOTTS BAKERY,6.5,,1400.59,Dine Out,Nottingham,UK
1469,14/06/2021,FPO,TRADING212UK,200.0,,1407.09,Investment,Nottingham,UK
1470,14/06/2021,DEB,ECOTRICITY,139.51,,1607.09,Home Improvement,Nottingham,UK
1471,14/06/2021,DEB,SAINSBURYS S/MKTS,37.78,,1746.6,Groceries,,
1472,2021-11-06 00:00:00,FPI,SHEILA SMITH,,400.0,1784.38,Supplementary Income,Nottingham,UK
1473,2021-11-06 00:00:00,BP,SAVE THE CHANGE,1.13,,1384.38,Savings,Nottingham,UK
1474,2021-10-06 00:00:00,FPO,ANTIGONI ABRAHMS,6.0,,1385.51,Entertainment,London,UK
1475,2021-10-06 00:00:00,DEB,AMZNMktplace,77.7,,1391.51,Amazon,Nottingham,UK
1476,2021-10-06 00:00:00,DEB,LIDL GB  NOTTINGHA,12.17,,1469.21,Groceries,Nottingham,UK
1477,2021-10-06 00:00:00,BP,SAVE THE CHANGE,1.81,,1481.38,Savings,Nottingham,UK
1478,2021-09-06 00:00:00,DEB,AMZNMktplace,43.93,,1483.19,Amazon,Nottingham,UK
1479,2021-09-06 00:00:00,DEB,STARBUCKS CAFE,7.18,,1527.12,Dine Out,,
1480,2021-09-06 00:00:00,DEB,SEVERN TRENT WATER,6.34,,1534.3,Bills,Nottingham,UK
1481,2021-09-06 00:00:00,DEB,AMZNMKTPLACE AMAZO,31.74,,1540.64,Amazon,Nottingham,UK
1482,2021-08-06 00:00:00,BP,SAVE THE CHANGE,0.01,,1572.38,Savings,Nottingham,UK
1483,2021-07-06 00:00:00,DEB,PureGym Limited,19.99,,1572.39,Fitness,Nottingham,UK
1484,2021-07-06 00:00:00,BP,SAVE THE CHANGE,0.93,,1592.38,Savings,Nottingham,UK
1485,2021-07-06 00:00:00,DEB,T K MAXX,16.99,,1593.31,Other Shopping,,
1486,2021-07-06 00:00:00,DEB,ORIENTAL MART HYDR,9.8,,1610.3,Groceries,Nottingham,UK
1487,2021-07-06 00:00:00,DEB,DOUGHNOTTS BAKERY,6.5,,1620.1,Dine Out,Nottingham,UK
1488,2021-07-06 00:00:00,DEB,LIDL GB  NOTTINGHA,8.78,,1626.6,Groceries,Nottingham,UK
1489,2021-04-06 00:00:00,DEP,CLUB LLOYDS WAIVED,,3.0,1635.38,Supplementary Income,Nottingham,UK
1490,2021-04-06 00:00:00,PAY,CLUB LLOYDS FEE,3.0,,1632.38,Bills,Nottingham,UK
1491,2021-04-06 00:00:00,FPO,ROBERT RECORD,30.0,,1635.38,Others,Nottingham,UK
1492,2021-04-06 00:00:00,BP,SAVE THE CHANGE,0.16,,1665.38,Savings,Nottingham,UK
1493,2021-03-06 00:00:00,DEB,LIDL GB  NOTTINGHA,14.84,,1665.54,Groceries,Nottingham,UK
1494,2021-03-06 00:00:00,FPO,ALICJA ALEXANDER,30.0,,1680.38,Services/Home Improvement,Nottingham,UK
1495,2021-02-06 00:00:00,BP,SAVE THE CHANGE,0.5,,1710.38,Savings,Nottingham,UK
1496,2021-01-06 00:00:00,,INTEREST (GROSS),,0.62,1710.88,Interest,Nottingham,UK
1497,2021-01-06 00:00:00,FPO,TAMBA TAM,10.0,,1710.26,Services,Nottingham,UK
1498,2021-01-06 00:00:00,DEB,Lush UK,20.0,,1720.26,Other Shopping,,
1499,2021-01-06 00:00:00,DEB,SUMMERS IN TIME DA,6.0,,1740.26,Others,Nottingham,UK
1500,2021-01-06 00:00:00,DEB,PIZZAMISU,18.5,,1746.26,Dine Out,Nottingham,UK
1501,2021-01-06 00:00:00,FPO,TRADING212UK,500.0,,1764.76,Investment,Nottingham,UK
1502,2021-01-06 00:00:00,DD,BARCLAYS UK MTGES,981.71,,2264.76,Bills,Nottingham,UK
1503,2021-01-06 00:00:00,DD,NOTTM CITY COUNC,157.0,,3246.47,Bills,Nottingham,UK
1504,2021-01-06 00:00:00,DD,OCTOPUS ENERGY,90.0,,3403.47,Bills,Nottingham,UK
1505,2021-01-06 00:00:00,SO,Q WANG,,1000.0,3493.47,Supplementary Income,Nottingham,UK
1506,2021-01-06 00:00:00,SO,ESAVINGS ACCOUNT,300.0,,2493.47,Savings,Nottingham,UK
1507,2021-01-06 00:00:00,BP,SAVE THE CHANGE,3.27,,2793.47,Savings,Nottingham,UK
1508,2021-01-06 00:00:00,DEB,LIDL GB  NOTTINGHA,12.24,,2796.74,Groceries,Nottingham,UK
1509,2021-01-06 00:00:00,DEB,AMZNMktplace,8.68,,2808.98,Amazon,Nottingham,UK
1510,2021-01-06 00:00:00,DEB,ORIENTAL MART HYDR,20.19,,2817.66,Groceries,Nottingham,UK
1511,2021-01-06 00:00:00,DEB,WILKO RETAIL LIMIT,9.0,,2837.85,Other Shopping,,
1512,2021-01-06 00:00:00,DEB,DOUGHNOTTS BAKERY,6.5,,2846.85,Dine Out,Nottingham,UK
1513,2021-01-06 00:00:00,DEB,GREGGS PLC,2.0,,2853.35,Dine Out,,
1514,2021-01-06 00:00:00,TFR,R LAWRENCE  29MAY21,,900.0,2855.35,Supplementary Income,Nottingham,UK
1515,2021-01-06 00:00:00,FPO,STEWART SCHOFIELD,850.0,,1955.35,Services,Nottingham,UK
1516,2021-01-06 00:00:00,DEB,AMZNMktplace,13.99,,2805.35,Amazon,Nottingham,UK
1517,2021-01-06 00:00:00,DEB,AMZNMktplace,11.18,,2819.34,Amazon,Nottingham,UK
1518,28/05/2021,DEB,AMZNMktplace,79.95,,2830.52,Amazon,Nottingham,UK
1519,28/05/2021,DEB,SUMMERS IN TIME DA,6.0,,2910.47,Others,Nottingham,UK
1520,28/05/2021,DD,TALKTALK LIMITED,21.95,,2916.47,Bills,Nottingham,UK
1521,28/05/2021,BP,SAVE THE CHANGE,0.68,,2938.42,Savings,Nottingham,UK
1522,27/05/2021,DEB,IZ *Nottingham Bik,50.0,,2939.1,Other Shopping,Nottingham,UK
1523,27/05/2021,DEB,LIDL GB  NOTTINGHA,10.32,,2989.1,Groceries,Nottingham,UK
1524,27/05/2021,FPO,TRADING212UK,1300.0,,2999.42,Investment,Nottingham,UK
1525,27/05/2021,BP,SAVE THE CHANGE,1.22,,4299.42,Savings,Nottingham,UK
1526,27/05/2021,BGC,UNIV OF NOTTINGHAM,,3756.18,4300.64,Paycheck,Nottingham,UK
1527,26/05/2021,DEB,AMZNMktplace,8.9,,544.46,Amazon,Nottingham,UK
1528,26/05/2021,DEB,AMZNMktplace,8.03,,553.36,Amazon,Nottingham,UK
1529,26/05/2021,DEB,LIDL GB  NOTTINGHA,5.85,,561.39,Groceries,Nottingham,UK
1530,26/05/2021,BP,SAVE THE CHANGE,0.01,,567.24,Savings,Nottingham,UK
1531,25/05/2021,FPO,TAMBA TAM,10.0,,567.25,Services,Nottingham,UK
1532,25/05/2021,DEB,AMZNMktplace,27.99,,577.25,Amazon,Nottingham,UK
1533,25/05/2021,BP,SAVE THE CHANGE,0.01,,605.24,Savings,Nottingham,UK
1534,24/05/2021,DEB,Audible UK,7.99,,605.25,Entertainment,Nottingham,UK
1535,24/05/2021,FPO,TRADING212UK,400.0,,613.24,Savings,Nottingham,UK
1536,24/05/2021,FPI,ABAYOMI ADAMS,,400.0,1013.24,Supplementary Income,Nottingham,UK
1537,24/05/2021,BP,SAVE THE CHANGE,2.94,,613.24,Investment,Nottingham,UK
1538,24/05/2021,DEB,LIDL GB  NOTTINGHA,13.59,,616.18,Groceries,Nottingham,UK
1539,24/05/2021,DEB,DOUGHNOTTS BAKERY,6.5,,629.77,Dine Out,Nottingham,UK
1540,24/05/2021,DEB,ORIENTAL MART HYDR,5.03,,636.27,Groceries,Nottingham,UK
1541,24/05/2021,DEB,WILKO RETAIL LIMIT,2.5,,641.3,Other Shopping,,
1542,21/05/2021,DEB,LIDL GB  NOTTINGHA,8.44,,643.8,Groceries,Nottingham,UK
1543,20/05/2021,FPO,TRADING212UK,100.0,,652.24,Investment,Nottingham,UK
1544,20/05/2021,FPO,ALICJA ALEXANDER,30.0,,752.24,Services/Home Improvement,Nottingham,UK
1545,20/05/2021,BP,SAVE THE CHANGE,0.87,,782.24,Savings,Nottingham,UK
1546,19/05/2021,DEB,AMZNMktplace,15.99,,783.11,Amazon,Nottingham,UK
1547,19/05/2021,DEB,AMAZON.CO.UK*MK3GT,10.14,,799.1,Amazon,Nottingham,UK
1548,19/05/2021,BP,SAVE THE CHANGE,0.32,,809.24,Savings,Nottingham,UK
1549,18/05/2021,FPO,TAMBA TAM,10.0,,809.56,Services,Nottingham,UK
1550,18/05/2021,DEB,LIDL GB  NOTTINGHA,15.68,,819.56,Groceries,Nottingham,UK
1551,18/05/2021,DEB,SUMMERS IN TIME DA,6.0,,835.24,Others,Nottingham,UK
1552,18/05/2021,CPT,LNK NOTTINGHAM UNI,40.0,,841.24,Cash,Nottingham,UK
1553,17/05/2021,DD,VIRGIN MEDIA PYMTS,25.5,,881.24,Bills,Nottingham,UK
1554,17/05/2021,DD,O2,16.66,,906.74,Other Shopping,Nottingham,UK
1555,17/05/2021,BP,SAVE THE CHANGE,1.56,,923.4,Savings,Nottingham,UK
1556,17/05/2021,DEB,ORIENTAL MART HYDR,9.77,,924.96,Groceries,Nottingham,UK
1557,17/05/2021,DEB,LIDL GB  NOTTINGHA,5.27,,934.73,Groceries,Nottingham,UK
1558,14/05/2021,DEB,AMZNMktplace,39.99,,940.0,Amazon,Nottingham,UK
1559,14/05/2021,DEB,LIDL GB  NOTTINGHA,16.93,,979.99,Groceries,Nottingham,UK
1560,14/05/2021,DEB,HPI INSTANT INK UK,3.49,,996.92,Other Shopping,,
1561,14/05/2021,DEB,AMAZON.CO.UK*MK65X,9.99,,1000.41,Amazon,Nottingham,UK
1562,14/05/2021,DEB,SKYPE.COM/GO/BILL,5.0,,1010.4,Bills,Nottingham,UK
1563,14/05/2021,BP,SAVE THE CHANGE,0.13,,1015.4,Savings,Nottingham,UK
1564,13/05/2021,DEB,AMZNMktplace,2.87,,1015.53,Amazon,Nottingham,UK
1565,13/05/2021,BP,SAVE THE CHANGE,0.66,,1018.4,Savings,Nottingham,UK
1566,2021-12-05 00:00:00,DEB,LIDL GB  NOTTINGHA,18.34,,1019.06,Groceries,Nottingham,UK
1567,2021-12-05 00:00:00,BP,SAVE THE CHANGE,0.01,,1037.4,Savings,Nottingham,UK
1568,2021-11-05 00:00:00,FPO,ROBERT RECORD,105.0,,1037.41,Others,Nottingham,UK
1569,2021-11-05 00:00:00,DEB,AMZNMktplace,9.99,,1142.41,Amazon,Nottingham,UK
1570,2021-11-05 00:00:00,FPO,PATRICIA A S LAW,300.0,,1152.4,Other Shopping,,
1571,2021-11-05 00:00:00,BP,SAVE THE CHANGE,0.1,,1452.4,Savings,Nottingham,UK
1572,2021-10-05 00:00:00,DEB,AMZNMktplace,13.99,,1452.5,Amazon,Nottingham,UK
1573,2021-10-05 00:00:00,DEB,SOLO GRANO,3.91,,1466.49,Dine Out,Nottingham,UK
1574,2021-10-05 00:00:00,BP,SAVE THE CHANGE,4.27,,1470.4,Savings,Nottingham,UK
1575,2021-10-05 00:00:00,DEB,ORIENTAL MART HYDR,10.34,,1474.67,Groceries,Nottingham,UK
1576,2021-10-05 00:00:00,DEB,T K MAXX,8.97,,1485.01,Other Shopping,,
1577,2021-10-05 00:00:00,DEB,Amazon.co.uk*MK585,6.49,,1493.98,Amazon,Nottingham,UK
1578,2021-10-05 00:00:00,DEB,PP*DOUGHNOTTS,6.0,,1500.47,Dine Out,Nottingham,UK
1579,2021-10-05 00:00:00,FPO,ANTIGONI ABRAHMS,5.0,,1506.47,Entertainment,London,UK
1580,2021-10-05 00:00:00,DEB,SHARIF AND SONS SU,7.29,,1511.47,Groceries,Derby,UK
1581,2021-10-05 00:00:00,DEB,AMZNMktplace,3.03,,1518.76,Amazon,Nottingham,UK
1582,2021-07-05 00:00:00,DEB,LIDL GB  NOTTINGHA,11.12,,1521.79,Groceries,Nottingham,UK
1583,2021-07-05 00:00:00,DEB,AMZNMktplace,2.49,,1532.91,Amazon,Nottingham,UK
1584,2021-07-05 00:00:00,DD,OCTOPUS ENERGY,90.0,,1535.4,Bills,Nottingham,UK
1585,2021-07-05 00:00:00,BP,SAVE THE CHANGE,1.24,,1625.4,Savings,Nottingham,UK
1586,2021-06-05 00:00:00,FPO,ALICJA ALEXANDER,30.0,,1626.64,Services/Home Improvement,Nottingham,UK
1587,2021-06-05 00:00:00,DEB,CLASSIC DOORS AND,78.0,,1656.64,Home Improvement,Nottingham,UK
1588,2021-06-05 00:00:00,DEB,Amazon.co.uk*MK78E,17.58,,1734.64,Amazon,Nottingham,UK
1589,2021-06-05 00:00:00,DEB,LIDL GB  NOTTINGHA,11.18,,1752.22,Groceries,Nottingham,UK
1590,2021-06-05 00:00:00,BP,SAVE THE CHANGE,0.97,,1763.4,Savings,Nottingham,UK
1591,2021-05-05 00:00:00,DEP,CLUB LLOYDS WAIVED,,3.0,1764.37,Amazon,Nottingham,UK
1592,2021-05-05 00:00:00,PAY,CLUB LLOYDS FEE,3.0,,1761.37,Bills,Nottingham,UK
1593,2021-05-05 00:00:00,DEB,AMZNMktplace,29.95,,1764.37,Supplementary Income,Nottingham,UK
1594,2021-05-05 00:00:00,DEB,AMZNMktplace,15.99,,1794.32,Amazon,Nottingham,UK
1595,2021-05-05 00:00:00,DEB,AMAZON.CO.UK*MK9J0,15.09,,1810.31,Amazon,Nottingham,UK
1596,2021-05-05 00:00:00,DEB,Amazon.co.uk*MK602,6.0,,1825.4,Amazon,Nottingham,UK
1597,2021-05-05 00:00:00,BP,SAVE THE CHANGE,0.2,,1831.4,Savings,Nottingham,UK
1598,2021-04-05 00:00:00,,INTEREST (GROSS),,0.74,1831.6,Interest,Nottingham,UK
1599,2021-04-05 00:00:00,DEB,CAFFE NERO 650 NOT,2.8,,1830.86,Dine Out,Nottingham,UK
1600,2021-04-05 00:00:00,FPO,TRADING212UK,600.0,,1833.66,Investment,Nottingham,UK
1601,2021-04-05 00:00:00,TFR,R LAWRENCE,,200.0,2433.66,Supplementary Income,Nottingham,UK
1602,2021-04-05 00:00:00,DD,BARCLAYS UK MTGES,981.71,,2233.66,Bills,Nottingham,UK
1603,2021-04-05 00:00:00,DD,NOTTM CITY COUNC,155.06,,3215.37,Bills,Nottingham,UK
1604,2021-04-05 00:00:00,SO,Q WANG,,1000.0,3370.43,Supplementary Income,Nottingham,UK
1605,2021-04-05 00:00:00,SO,ESAVINGS ACCOUNT,300.0,,2370.43,Savings,Nottingham,UK
1606,2021-04-05 00:00:00,BP,SAVE THE CHANGE,2.23,,2670.43,Savings,Nottingham,UK
1607,2021-04-05 00:00:00,DEB,PP*DOUGHNOTTS,6.5,,2672.66,Dine Out,Nottingham,UK
1608,2021-04-05 00:00:00,FPO,ROBERT RECORD,45.0,,2679.16,Others,Nottingham,UK
1609,2021-04-05 00:00:00,DEB,ORIENTAL MART HYDR,14.25,,2724.16,Groceries,Nottingham,UK
1610,2021-04-05 00:00:00,DEB,WILKO RETAIL LIMIT,6.0,,2738.41,Other Shopping,,
1611,2021-04-05 00:00:00,DEB,SOLO GRANO,3.47,,2744.41,Dine Out,Nottingham,UK
1612,2021-04-05 00:00:00,DEB,LIDL GB  NOTTINGHA,12.88,,2747.88,Groceries,Nottingham,UK
1613,2021-04-05 00:00:00,DEB,AMZNMKTPLACE AMAZO,5.67,,2760.76,Amazon,Nottingham,UK
1614,2021-04-05 00:00:00,FPO,ANTIGONI ABRAHMS,5.0,,2766.43,Entertainment,London,UK
1615,30/04/2021,DEB,AMAZON.CO.UK*MK74Z,3.0,,2771.43,Amazon,Nottingham,UK
1616,30/04/2021,BP,SAVE THE CHANGE,1.51,,2774.43,Savings,Nottingham,UK
1617,29/04/2021,DEB,ECOTRICITY,130.61,,2775.94,Home Improvement,Nottingham,UK
1618,29/04/2021,DEB,LIDL GB  NOTTINGHA,12.19,,2906.55,Groceries,Nottingham,UK
1619,29/04/2021,DEB,AMZNMKTPLACE AMAZO,2.69,,2918.74,Amazon,Nottingham,UK
1620,29/04/2021,FPO,TRADING212UK,1000.0,,2921.43,Investment,Nottingham,UK
1621,29/04/2021,FPO,TRADING212UK,293.0,,3921.43,Investment,Nottingham,UK
1622,29/04/2021,BGC,UNIV OF NOTTINGHAM,,3756.59,4214.43,Paycheck,Nottingham,UK
1623,28/04/2021,FPO,TRADING212UK,100.0,,457.84,Investment,Nottingham,UK
1624,28/04/2021,FPO,MR IAN ELLIS,110.0,,557.84,Services,Nottingham,UK
1625,28/04/2021,BP,SAVE THE CHANGE,0.35,,667.84,Savings,Nottingham,UK
1626,27/04/2021,DEB,SHARIF AND SONS SU,19.65,,668.19,Groceries,Derby,UK
1627,27/04/2021,DD,TALKTALK LIMITED,21.95,,687.84,Bills,Nottingham,UK
1628,26/04/2021,FPO,TRADING212UK,200.0,,709.79,Investment,Nottingham,UK
1629,26/04/2021,BP,SAVE THE CHANGE,3.67,,909.79,Savings,Nottingham,UK
1630,26/04/2021,DEB,EAST MIDS RAILWAY,19.4,,913.46,Travel,Nottingham,UK
1631,26/04/2021,DEB,LIDL GB  NOTTINGHA,9.3,,932.86,Groceries,Nottingham,UK
1632,26/04/2021,DEB,AMZNMktplace,14.99,,942.16,Amazon,Nottingham,UK
1633,26/04/2021,DEB,Amazon.co.uk*M40A6,10.81,,957.15,Amazon,Nottingham,UK
1634,26/04/2021,DEB,Audible UK,7.99,,967.96,Entertainment,Nottingham,UK
1635,26/04/2021,DEB,AMZNMktplace,3.22,,975.95,Amazon,Nottingham,UK
1636,26/04/2021,DEB,AMZNMKTPLACE AMAZO,4.48,,979.17,Amazon,Nottingham,UK
1637,26/04/2021,FPI,ABAYOMI ADAMS,,400.0,983.65,Supplementary Income,Nottingham,UK
1638,23/04/2021,DEB,AMZNMktplace,100.8,,583.65,Amazon,Nottingham,UK
1639,23/04/2021,DEB,SAINSBURYS S/MKT,38.79,,684.45,Groceries,Nottingham,
1640,23/04/2021,DEB,AMAZON.CO.UK*M44AQ,26.55,,723.24,Amazon,Nottingham,UK
1641,23/04/2021,BGC,GOOGLE IRELAND,,61.27,749.79,Supplementary Income,Nottingham,UK
1642,22/04/2021,FPO,TRADING212UK,200.0,,688.52,Investment,Nottingham,UK
1643,22/04/2021,FPI,MARK NEAL WINSTEIN,,395.51,888.52,Supplementary Income,Nottingham,UK
1644,22/04/2021,BP,SAVE THE CHANGE,0.73,,493.01,Savings,Nottingham,UK
1645,21/04/2021,DEB,LIDL GB  NOTTINGHA,15.27,,493.74,Groceries,Nottingham,UK
1646,20/04/2021,FPO,ALICJA ALEXANDER,25.0,,509.01,Services/Home Improvement,Nottingham,UK
1647,20/04/2021,BP,SAVE THE CHANGE,0.51,,534.01,Savings,Nottingham,UK
1648,19/04/2021,DEB,AMZNMktplace,6.99,,534.52,Amazon,Nottingham,UK
1649,19/04/2021,DEB,PP*DOUGHNOTTS,6.5,,541.51,Dine Out,Nottingham,UK
1650,19/04/2021,DD,VIRGIN MEDIA PYMTS,25.5,,548.01,Bills,Nottingham,UK
1651,19/04/2021,BP,SAVE THE CHANGE,1.06,,573.51,Savings,Nottingham,UK
1652,19/04/2021,DEB,T K MAXX,41.96,,574.57,Other Shopping,Nottingham,
1653,19/04/2021,DEB,ORIENTAL MART HYDR,7.48,,616.53,Groceries,Nottingham,UK
1654,19/04/2021,DEB,WILKO RETAIL LIMIT,4.5,,624.01,Other Shopping,Nottingham,
1655,19/04/2021,FPO,ANTIGONI ABRAHMS,5.0,,628.51,Entertainment,London,UK
1656,16/04/2021,DD,O2,16.66,,633.51,Other Shopping,Nottingham,UK
1657,16/04/2021,BP,SAVE THE CHANGE,0.91,,650.17,Savings,Nottingham,UK
1658,15/04/2021,DEB,AMAZON.CO.UK*M46EG,69.09,,651.08,Amazon,Nottingham,UK
1659,15/04/2021,BP,SAVE THE CHANGE,0.7,,720.17,Savings,Nottingham,UK
1660,14/04/2021,DEB,LIDL GB  NOTTINGHA,16.3,,720.87,Groceries,Nottingham,UK
1661,14/04/2021,FPO,MR IAN ELLIS,255.0,,737.17,Services,Nottingham,UK
1662,14/04/2021,BP,SAVE THE CHANGE,0.51,,992.17,Savings,Nottingham,UK
1663,13/04/2021,DEB,HPI INSTANT INK UK,3.49,,992.68,Other Shopping,,
1664,13/04/2021,BP,SAVE THE CHANGE,1.6,,996.17,Savings,Nottingham,UK
1665,2021-12-04 00:00:00,DEB,SOLO GRANO,3.05,,997.77,Dine Out,Nottingham,UK
1666,2021-12-04 00:00:00,DEB,TESCO STORES 5954,2.0,,1000.82,Groceries,,
1667,2021-12-04 00:00:00,DEB,CAFFE NERO 650 NOT,3.35,,1002.82,Dine Out,Nottingham,UK
1668,2021-12-04 00:00:00,BP,SAVE THE CHANGE,1.35,,1006.17,Savings,Nottingham,UK
1669,2021-12-04 00:00:00,DEB,ORIENTAL MART HYDR,13.91,,1007.52,Groceries,Nottingham,UK
1670,2021-12-04 00:00:00,DEB,TESCO STORE 2960,10.09,,1021.43,Groceries,,
1671,2021-12-04 00:00:00,DEB,WWW.DOUGHN* DOUGHN,6.8,,1031.52,Dine Out,Nottingham,UK
1672,2021-12-04 00:00:00,FPO,ANTIGONI ABRAHMS,5.0,,1038.32,Entertainment,London,UK
1673,2021-12-04 00:00:00,DEB,ECOTRICITY,500.0,,1043.32,Home Improvement,Nottingham,UK
1674,2021-12-04 00:00:00,DEB,AMZNMktplace,43.99,,1543.32,Amazon,Nottingham,UK
1675,2021-09-04 00:00:00,DEB,LIDL GB  NOTTINGHA,10.86,,1587.31,Groceries,Nottingham,UK
1676,2021-09-04 00:00:00,BP,SAVE THE CHANGE,0.01,,1598.17,Savings,Nottingham,UK
1677,2021-08-04 00:00:00,DEB,AMZNMktplace,6.0,,1598.18,Amazon,Nottingham,UK
1678,2021-08-04 00:00:00,DEB,AMZNMKTPLACE AMAZO,7.99,,1604.18,Amazon,Nottingham,UK
1679,2021-08-04 00:00:00,BP,SAVE THE CHANGE,0.2,,1612.17,Savings,Nottingham,UK
1680,2021-07-04 00:00:00,FPO,ALICJA ALEXANDER,25.0,,1612.37,Services/Home Improvement,Nottingham,UK
1681,2021-07-04 00:00:00,DEB,LIDL GB  NOTTINGHA,18.8,,1637.37,Groceries,Nottingham,UK
1682,2021-07-04 00:00:00,BP,SAVE THE CHANGE,0.08,,1656.17,Savings,Nottingham,UK
1683,2021-06-04 00:00:00,DEP,CLUB LLOYDS WAIVED,,3.0,1656.25,Amazon,Nottingham,UK
1684,2021-06-04 00:00:00,PAY,CLUB LLOYDS FEE,3.0,,1653.25,Bills,Nottingham,UK
1685,2021-06-04 00:00:00,DEB,AMZNMktplace,107.95,,1656.25,Supplementary Income,Nottingham,UK
1686,2021-06-04 00:00:00,DEB,AMZNMktplace,24.98,,1764.2,Amazon,Nottingham,UK
1687,2021-06-04 00:00:00,DEB,AMZNMktplace,19.99,,1789.18,Amazon,Nottingham,UK
1688,2021-06-04 00:00:00,FPO,TRADING212UK,500.0,,1809.17,Investment,Nottingham,UK
1689,2021-06-04 00:00:00,BP,SAVE THE CHANGE,3.44,,2309.17,Savings,Nottingham,UK
1690,2021-06-04 00:00:00,DEB,SOLO GRANO,5.7,,2312.61,Dine Out,Nottingham,UK
1691,2021-06-04 00:00:00,DEB,SOLO GRANO,3.36,,2318.31,Dine Out,Nottingham,UK
1692,2021-06-04 00:00:00,FPI,MIAH MA,,98.5,2321.67,Supplementary Income,Nottingham,UK
1693,2021-06-04 00:00:00,DEB,ORIENTAL MART HYDR,12.19,,2223.17,Groceries,Nottingham,UK
1694,2021-06-04 00:00:00,DEB,WWW.DOUGHN* DOUGHN,6.8,,2235.36,Dine Out,Nottingham,UK
1695,2021-06-04 00:00:00,DEB,WILKO RETAIL LIMIT,3.25,,2242.16,Other Shopping,,
1696,2021-06-04 00:00:00,FPO,ANTIGONI ABRAHMS,5.0,,2245.41,Entertainment,London,UK
1697,2021-06-04 00:00:00,DEB,AMZNMktplace,16.99,,2250.41,Amazon,Nottingham,UK
1698,2021-06-04 00:00:00,DEB,LIDL GB  NOTTINGHA,16.74,,2267.4,Groceries,Nottingham,UK
1699,2021-06-04 00:00:00,DEB,AMZNMktplace,8.59,,2284.14,Amazon,Nottingham,UK
1700,2021-06-04 00:00:00,DEB,AMAZON.CO.UK*MU384,6.0,,2292.73,Amazon,Nottingham,UK
1701,2021-06-04 00:00:00,FPO,MR IAN ELLIS,140.0,,2298.73,Services,Nottingham,UK
1702,2021-06-04 00:00:00,DEB,AMZNMktplace,17.99,,2438.73,Amazon,Nottingham,UK
1703,2021-01-04 00:00:00,,INTEREST (GROSS),,0.48,2456.72,Interest,Nottingham,UK
1704,2021-01-04 00:00:00,DEB,AMZNMktplace,58.96,,2456.24,Amazon,Nottingham,UK
1705,2021-01-04 00:00:00,DEB,AMZNMktplace,8.99,,2515.2,Amazon,Nottingham,UK
1706,2021-01-04 00:00:00,DD,BARCLAYS UK MTGES,981.71,,2524.19,Bills,Nottingham,UK
1707,2021-01-04 00:00:00,SO,Q WANG,,1000.0,3505.9,Supplementary Income,Nottingham,UK
1708,2021-01-04 00:00:00,SO,ESAVINGS ACCOUNT,300.0,,2505.9,Savings,Nottingham,UK
1709,2021-01-04 00:00:00,BP,SAVE THE CHANGE,0.19,,2805.9,Savings,Nottingham,UK
1710,31/03/2021,DEB,AMZNMktplace,16.99,,2806.09,Amazon,Nottingham,UK
1711,31/03/2021,DEB,LIDL GB  NOTTINGHA,6.82,,2823.08,Groceries,Nottingham,UK
1712,31/03/2021,DEB,AMZ*hzmizimi,,16.99,2829.9,Supplementary Income,Nottingham,UK
1713,31/03/2021,BP,SAVE THE CHANGE,0.23,,2812.91,Savings,Nottingham,UK
1714,30/03/2021,DEB,SHARIF AND SONS SU,13.77,,2813.14,Groceries,Derby,UK
1715,30/03/2021,FPO,TRADING212UK,1000.0,,2826.91,Investment,Nottingham,UK
1716,30/03/2021,BP,SAVE THE CHANGE,0.95,,3826.91,Savings,Nottingham,UK
1717,30/03/2021,BGC,UNIV OF NOTTINGHAM,,3665.25,3827.86,Paycheck,Nottingham,UK
1718,29/03/2021,DEB,SOLO GRANO,8.05,,162.61,Dine Out,Nottingham,UK
1719,29/03/2021,BP,SAVE THE CHANGE,1.09,,170.66,Savings,Nottingham,UK
1720,29/03/2021,DEB,ORIENTAL MART HYDR,12.89,,171.75,Groceries,Nottingham,UK
1721,29/03/2021,DEB,WAITROSE 833,10.23,,184.64,,Nottingham,UK
1722,29/03/2021,DEB,WWW.DOUGHN* DOUGHN,6.8,,194.87,Dine Out,Nottingham,UK
1723,29/03/2021,FPO,ANTIGONI ABRAHMS,5.0,,201.67,Entertainment,London,UK
1724,29/03/2021,DEB,AMZNMktplace,16.99,,206.67,Amazon,Nottingham,UK
1725,26/03/2021,DD,TALKTALK LIMITED,19.95,,223.66,Bills,Nottingham,UK
1726,26/03/2021,BP,SAVE THE CHANGE,0.6,,243.61,Savings,Nottingham,UK
1727,25/03/2021,DEB,AMZNMktplace,16.99,,244.21,Amazon,Nottingham,UK
1728,25/03/2021,DEB,LIDL GB  NOTTINGHA,4.41,,261.2,Groceries,Nottingham,UK
1729,25/03/2021,FPO,TRADING212UK,200.0,,265.61,Investment,Nottingham,UK
1730,25/03/2021,FPI,YEWANDE MARIAN ADE,,400.0,465.61,Supplementary Income,Nottingham,UK
1731,25/03/2021,BP,SAVE THE CHANGE,0.02,,65.61,Savings,Nottingham,UK
1732,24/03/2021,DEB,IKEA LTD SHOP ONLI,320.0,,65.63,Other Shopping,,
1733,24/03/2021,DEB,AMZNMKTPLACE AMAZO,74.99,,385.63,Amazon,Nottingham,UK
1734,24/03/2021,DEB,Audible UK,7.99,,460.62,Entertainment,Nottingham,UK
1735,24/03/2021,TFR,R LAWRENCE,,50.0,468.61,Supplementary Income,Nottingham,UK
1736,23/03/2021,DEB,LIDL GB  NOTTINGHA,11.1,,418.61,Groceries,Nottingham,UK
1737,23/03/2021,FPO,ALICJA ALEXANDER,25.0,,429.71,Services/Home Improvement,Nottingham,UK
1738,23/03/2021,BP,SAVE THE CHANGE,0.71,,454.71,Savings,Nottingham,UK
1739,22/03/2021,DEB,ORIENTAL MART HYDR,22.49,,455.42,Groceries,Nottingham,UK
1740,22/03/2021,DEB,WWW.DOUGHN* DOUGHN,6.8,,477.91,Dine Out,Nottingham,UK
1741,22/03/2021,DEB,UBER   *TRIP,2.0,,484.71,Travel,Nottingham,UK
1742,22/03/2021,BP,SAVE THE CHANGE,1.07,,486.71,Savings,Nottingham,UK
1743,22/03/2021,DEB,UBER *TRIP HELP.UB,13.66,,487.78,Travel,Nottingham,UK
1744,22/03/2021,FPO,ANTIGONI ABRAHMS,5.0,,501.44,Entertainment,London,UK
1745,22/03/2021,DEB,Audible UK,18.0,,506.44,Entertainment,Nottingham,UK
1746,22/03/2021,DEB,LIDL GB  NOTTINGHA,17.28,,524.44,Groceries,Nottingham,UK
1747,19/03/2021,FPO,TRADING212UK,100.0,,541.72,Investment,Nottingham,UK
1748,19/03/2021,DEB,AMZNMktplace,6.99,,641.72,Amazon,Nottingham,UK
1749,19/03/2021,BP,SAVE THE CHANGE,0.26,,648.71,Savings,Nottingham,UK
1750,18/03/2021,DEB,TESCO STORES 5368,3.74,,648.97,Groceries,,
1751,18/03/2021,BP,SAVE THE CHANGE,0.5,,652.71,Savings,Nottingham,UK
1752,17/03/2021,DEB,LIDL GB  NOTTINGHA,5.87,,653.21,Groceries,Nottingham,UK
1753,17/03/2021,DEB,AMZNMktplace,3.63,,659.08,Amazon,Nottingham,UK
1754,17/03/2021,DD,VIRGIN MEDIA PYMTS,25.5,,662.71,Bills,Nottingham,UK
1755,17/03/2021,BP,SAVE THE CHANGE,0.8,,688.21,Savings,Nottingham,UK
1756,16/03/2021,DEB,AMZNMKTPLACE AMAZO,18.2,,689.01,Amazon,Nottingham,UK
1757,16/03/2021,DD,O2,16.44,,707.21,Other Shopping,Nottingham,UK
1758,16/03/2021,BP,SAVE THE CHANGE,1.35,,723.65,Savings,Nottingham,UK
1759,15/03/2021,DEB,SOLO GRANO,9.25,,725.0,Dine Out,Nottingham,UK
1760,15/03/2021,DEB,AMZNMKTPLACE AMAZO,6.4,,734.25,Amazon,Nottingham,UK
1761,15/03/2021,BP,SAVE THE CHANGE,1.7,,740.65,Savings,Nottingham,UK
1762,15/03/2021,DEB,ORIENTAL MART HYDR,13.02,,742.35,Groceries,Nottingham,UK
1763,15/03/2021,DEB,WWW.DOUGHNOTTSOFFI,6.8,,755.37,Dine Out,Nottingham,UK
1764,15/03/2021,DEB,HPI INSTANT INK UK,7.49,,762.17,Other Shopping,,
1765,2021-12-03 00:00:00,DEB,Amazon.co.uk*MM61F,186.99,,769.66,Amazon,Nottingham,UK
1766,2021-12-03 00:00:00,BP,SAVE THE CHANGE,1.0,,956.65,Savings,Nottingham,UK
1767,2021-11-03 00:00:00,DEB,AMZNMktplace,5.14,,957.65,Amazon,Nottingham,UK
1768,2021-11-03 00:00:00,DEB,AMZNMKTPLACE AMAZO,42.86,,962.79,Amazon,Nottingham,UK
1769,2021-10-03 00:00:00,FPO,ALICJA ALEXANDER,25.0,,1005.65,Services/Home Improvement,Nottingham,UK
1770,2021-10-03 00:00:00,BP,SAVE THE CHANGE,0.84,,1030.65,Savings,Nottingham,UK
1771,2021-09-03 00:00:00,DEB,Amazon Prime*MM728,79.0,,1031.49,Amazon,Nottingham,UK
1772,2021-09-03 00:00:00,DEB,AMZNMktplace,19.92,,1110.49,Amazon,Nottingham,UK
1773,2021-09-03 00:00:00,DEB,LIDL GB  NOTTINGHA,10.24,,1130.41,Groceries,Nottingham,UK
1774,2021-09-03 00:00:00,BP,SAVE THE CHANGE,0.06,,1140.65,Savings,Nottingham,UK
1775,2021-08-03 00:00:00,DEB,ORIENTAL MART HYDR,13.94,,1140.71,Groceries,Nottingham,UK
1776,2021-08-03 00:00:00,FPO,KYLE MCDERMOTT,208.8,,1154.65,Services,Nottingham,UK
1777,2021-08-03 00:00:00,BP,SAVE THE CHANGE,1.53,,1363.45,Savings,Nottingham,UK
1778,2021-08-03 00:00:00,DEB,WWW.DOUGHNOTTSOFFI,6.8,,1364.98,Dine Out,Nottingham,UK
1779,2021-08-03 00:00:00,DEB,TESCO STORE 2960,2.0,,1371.78,Groceries,,
1780,2021-08-03 00:00:00,FPO,ANTIGONI ABRAHMS,5.0,,1373.78,Entertainment,London,UK
1781,2021-08-03 00:00:00,DEB,Amazon.co.uk*MM82L,28.66,,1378.78,Amazon,Nottingham,UK
1782,2021-05-03 00:00:00,FPO,ROBERT RECORD,100.0,,1407.44,Others,Nottingham,UK
1783,2021-05-03 00:00:00,DEB,Amazon.co.uk*MM0OR,29.99,,1507.44,Amazon,Nottingham,UK
1784,2021-05-03 00:00:00,DEB,LIDL GB  NOTTINGHA,7.02,,1537.43,Groceries,Nottingham,UK
1785,2021-04-03 00:00:00,BP,SAVE THE CHANGE,0.75,,1544.45,Savings,Nottingham,UK
1786,2021-03-03 00:00:00,DEB,SAINSBURYS S/MKT,22.25,,1545.2,Groceries,,
1787,2021-03-03 00:00:00,BP,SAVE THE CHANGE,1.27,,1567.45,Savings,Nottingham,UK
1788,2021-02-03 00:00:00,DEP,CLUB LLOYDS WAIVED,,3.0,1568.72,Supplementary Income,Nottingham,UK
1789,2021-02-03 00:00:00,PAY,CLUB LLOYDS FEE,3.0,,1565.72,Bills,Nottingham,UK
1790,2021-02-03 00:00:00,DEB,LIDL GB  NOTTINGHA,9.24,,1568.72,Groceries,Nottingham,UK
1791,2021-02-03 00:00:00,DEB,AMAZON.CO.UK*MM4J6,28.49,,1577.96,Amazon,Nottingham,UK
1792,2021-02-03 00:00:00,FPI,IISL CLIENT GBP SE,,17.77,1606.45,Supplementary Income,Nottingham,UK
1793,2021-02-03 00:00:00,FPI,IISL CLIENT GBP SE,,15.19,1588.68,Supplementary Income,Nottingham,UK
1794,2021-02-03 00:00:00,BP,SAVE THE CHANGE,0.45,,1573.49,Savings,Nottingham,UK
1795,2021-01-03 00:00:00,,INTEREST (GROSS),,0.57,1573.94,Interest,Nottingham,UK
1796,2021-01-03 00:00:00,DEB,TESCO STORES 6735,4.55,,1573.37,Groceries,,
1797,2021-01-03 00:00:00,FPO,TRADING212UK,500.0,,1577.92,Investment,Nottingham,UK
1798,2021-01-03 00:00:00,DD,BARCLAYS UK MTGES,981.71,,2077.92,Bills,Nottingham,UK
1799,2021-01-03 00:00:00,SO,Q WANG,,1000.0,3059.63,Supplementary Income,Nottingham,UK
1800,2021-01-03 00:00:00,SO,ESAVINGS ACCOUNT,300.0,,2059.63,Savings,Nottingham,UK
1801,2021-01-03 00:00:00,BP,SAVE THE CHANGE,1.65,,2359.63,Savings,Nottingham,UK
1802,2021-01-03 00:00:00,DEB,ORIENTAL MART HYDR,14.31,,2361.28,Groceries,Nottingham,UK
1803,2021-01-03 00:00:00,DEB,WWW.DOUGHNOTTSOFFI,6.8,,2375.59,Dine Out,Nottingham,UK
1804,2021-01-03 00:00:00,FPO,ANTIGONI ABRAHMS,5.0,,2382.39,Entertainment,London,UK
1805,26/02/2021,DEB,CARPETRIGHT,497.48,,2387.39,Home Improvement,Nottingham,UK
1806,26/02/2021,DEB,AMZNMktplace,42.97,,2884.87,Amazon,Nottingham,UK
1807,26/02/2021,DEB,LIDL GB  NOTTINGHA,5.79,,2927.84,Groceries,Nottingham,UK
1808,26/02/2021,DD,TALKTALK LIMITED,19.95,,2933.63,Bills,Nottingham,UK
1809,26/02/2021,BP,SAVE THE CHANGE,0.65,,2953.58,Savings,Nottingham,UK
1810,25/02/2021,DEB,Trading212UK,201.4,,2954.23,Investment,Nottingham,UK
1811,25/02/2021,DEB,WILKO RETAIL LIMIT,13.95,,3155.63,Other Shopping,,
1812,25/02/2021,FPO,TRADING212UK,1000.0,,3169.58,Investment,Nottingham,UK
1813,25/02/2021,BP,SAVE THE CHANGE,0.01,,4169.58,Savings,Nottingham,UK
1814,25/02/2021,BGC,UNIV OF NOTTINGHAM,,3665.25,4169.59,Paycheck,Nottingham,UK
1815,24/02/2021,DEB,CLASSIC DOORS AND,264.0,,504.34,Home Improvement,Nottingham,UK
1816,24/02/2021,DEB,Audible UK,7.99,,768.34,Entertainment,Nottingham,UK
1817,24/02/2021,BP,SAVE THE CHANGE,1.47,,776.33,Savings,Nottingham,UK
1818,23/02/2021,DEB,LIDL GB  NOTTINGHA,6.11,,777.8,Groceries,Nottingham,UK
1819,23/02/2021,DEB,LIDL GB  NOTTINGHA,4.42,,783.91,Groceries,Nottingham,UK
1820,23/02/2021,FPI,YEWANDE MARIAN ADE,,400.0,788.33,Supplementary Income,Nottingham,UK
1821,23/02/2021,TFR,R LAWRENCE,,100.0,388.33,Supplementary Income,Nottingham,UK
1822,23/02/2021,FPO,ALICJA ALEXANDER,25.0,,288.33,Services/Home Improvement,Nottingham,UK
1823,23/02/2021,BP,SAVE THE CHANGE,1.05,,313.33,Savings,Nottingham,UK
1824,22/02/2021,DEB,AMZNMktplace,15.9,,314.38,Amazon,Nottingham,UK
1825,22/02/2021,DEB,SOLO GRANO,9.05,,330.28,Dine Out,Nottingham,UK
1826,22/02/2021,BP,SAVE THE CHANGE,2.99,,339.33,Savings,Nottingham,UK
1827,22/02/2021,DEB,ORIENTAL MART HYDR,19.16,,342.32,Groceries,Nottingham,UK
1828,22/02/2021,DEB,WWW.DOUGHNOTTSOFFI,10.05,,361.48,Dine Out,Nottingham,UK
1829,22/02/2021,DEB,WWW.DOUGHNOTTSOFFI,3.55,,371.53,Dine Out,Nottingham,UK
1830,22/02/2021,DEB,PRET A MANGER,2.99,,375.08,Dine Out,,
1831,22/02/2021,FPO,ANTIGONI ABRAHMS,5.0,,378.07,Entertainment,London,UK
1832,22/02/2021,DEB,LIDL GB  NOTTINGHA,8.26,,383.07,Groceries,Nottingham,UK
1833,19/02/2021,FPO,ANTONY GRICE (PLUM,93.6,,391.33,Home Improvement,Nottingham,UK
1834,19/02/2021,FPI,IISL CLIENT GBP SE,,43.51,484.93,Supplementary Income,Nottingham,UK
1835,18/02/2021,BP,SAVE THE CHANGE,0.77,,441.42,Savings,Nottingham,UK
1836,17/02/2021,DEB,SHARIF AND SONS SU,18.23,,442.19,Groceries,Derby,UK
1837,17/02/2021,DD,VIRGIN MEDIA PYMTS,25.5,,460.42,Bills,Nottingham,UK
1838,17/02/2021,BP,SAVE THE CHANGE,0.01,,485.92,Savings,Nottingham,UK
1839,16/02/2021,DEB,SHARIF AND SONS SU,40.99,,485.93,Groceries,Derby,UK
1840,16/02/2021,DD,O2,16.44,,526.92,Other Shopping,Nottingham,UK
1841,16/02/2021,BP,SAVE THE CHANGE,1.66,,543.36,Savings,Nottingham,UK
1842,15/02/2021,DEB,AMZNMktplace,23.69,,545.02,Amazon,Nottingham,UK
1843,15/02/2021,DEB,TESCO STORE 2960,5.5,,568.71,Groceries,,
1844,15/02/2021,DEB,SOLO GRANO,3.15,,574.21,Dine Out,Nottingham,UK
1845,15/02/2021,BP,SAVE THE CHANGE,5.43,,577.36,Savings,Nottingham,UK
1846,15/02/2021,DEB,ORIENTAL MART HYDR,18.88,,582.79,Groceries,Nottingham,UK
1847,15/02/2021,DEB,WWW.DOUGHNOTTSOFFI,10.05,,601.67,Dine Out,Nottingham,UK
1848,15/02/2021,DEB,AMZNMKTPLACE AMAZO,3.21,,611.72,Amazon,Nottingham,UK
1849,15/02/2021,DEB,HPI INSTANT INK UK,6.49,,614.93,Other Shopping,,
1850,15/02/2021,FPO,ANTIGONI ABRAHMS,5.0,,621.42,Entertainment,London,UK
1851,15/02/2021,DEB,Trading212UK,151.05,,626.42,Investment,Nottingham,UK
1852,15/02/2021,DEB,Trading212UK,151.05,,777.47,Investment,Nottingham,UK
1853,15/02/2021,DEB,CLASSIC DOORS AND,66.0,,928.52,Home Improvement,Nottingham,UK
1854,15/02/2021,DEB,V Spot,33.72,,994.52,Dine Out,Nottingham,UK
1855,2021-12-02 00:00:00,DEB,Amazon.co.uk*MF1LV,15.12,,1028.24,Amazon,Nottingham,UK
1856,2021-12-02 00:00:00,DEB,APOLLO BLINDS,415.0,,1043.36,Home Improvement,Nottingham,UK
1857,2021-11-02 00:00:00,DEB,ADI PRO LEAK LTD,594.0,,1458.36,Home Improvement,Nottingham,UK
1858,2021-11-02 00:00:00,FPI,S.H.S.,,240.0,2052.36,Supplementary Income,Nottingham,UK
1859,2021-10-02 00:00:00,TFR,R LAWRENCE,,500.0,1812.36,Supplementary Income,Nottingham,UK
1860,2021-10-02 00:00:00,BP,SAVE THE CHANGE,0.21,,1312.36,Savings,Nottingham,UK
1861,2021-09-02 00:00:00,FPO,ALICJA ALEXANDER,25.0,,1312.57,Services/Home Improvement,Nottingham,UK
1862,2021-09-02 00:00:00,DEB,LIDL GB  NOTTINGHA,7.79,,1337.57,Groceries,Nottingham,UK
1863,2021-09-02 00:00:00,BP,SAVE THE CHANGE,0.97,,1345.36,Savings,Nottingham,UK
1864,2021-08-02 00:00:00,DEB,LIDL GB  NOTTINGHA,12.03,,1346.33,Groceries,Nottingham,UK
1865,2021-08-02 00:00:00,BP,SAVE THE CHANGE,1.66,,1358.36,Savings,Nottingham,UK
1866,2021-08-02 00:00:00,DEB,ORIENTAL MART HYDR,24.49,,1360.02,Groceries,Nottingham,UK
1867,2021-08-02 00:00:00,DEB,AMZNMktplace,19.96,,1384.51,Amazon,Nottingham,UK
1868,2021-08-02 00:00:00,DEB,WWW.DOUGHNOTTSOFFI,10.05,,1404.47,Dine Out,Nottingham,UK
1869,2021-08-02 00:00:00,FPO,ANTIGONI ABRAHMS,5.0,,1414.52,Entertainment,London,UK
1870,2021-05-02 00:00:00,DEB,Trading212UK,553.85,,1419.52,Investment,Nottingham,UK
1871,2021-05-02 00:00:00,DEB,AMZNMktplace,11.99,,1973.37,Amazon,Nottingham,UK
1872,2021-05-02 00:00:00,FPI,IISL CLIENT GBP SE,,1.0,1985.36,Supplementary Income,Nottingham,UK
1873,2021-04-02 00:00:00,DEB,Trading212UK,,1.0,1984.36,Supplementary Income,Nottingham,UK
1874,2021-04-02 00:00:00,BP,SAVE THE CHANGE,0.87,,1983.36,Savings,Nottingham,UK
1875,2021-03-02 00:00:00,DEB,LIDL GB  NOTTINGHA,8.13,,1984.23,Groceries,Nottingham,UK
1876,2021-03-02 00:00:00,BP,SAVE THE CHANGE,0.5,,1992.36,Savings,Nottingham,UK
1877,2021-02-02 00:00:00,DEP,CLUB LLOYDS WAIVED,,3.0,1992.86,Supplementary Income,Nottingham,UK
1878,2021-02-02 00:00:00,PAY,CLUB LLOYDS FEE,3.0,,1989.86,Bills,Nottingham,UK
1879,2021-02-02 00:00:00,DEB,Trading212UK,503.5,,1992.86,Investment,Nottingham,UK
1880,2021-01-02 00:00:00,,INTEREST (GROSS),,0.56,2496.36,Interest,Nottingham,UK
1881,2021-01-02 00:00:00,FPO,SHS,240.0,,2495.8,Home Improvement,Nottingham,UK
1882,2021-01-02 00:00:00,TFR,R LAWRENCE,,128.0,2735.8,Supplementary Income,Nottingham,UK
1883,2021-01-02 00:00:00,DD,BARCLAYS UK MTGES,981.71,,2607.8,Bills,Nottingham,UK
1884,2021-01-02 00:00:00,SO,Q WANG,,1000.0,3589.51,Supplementary Income,Nottingham,UK
1885,2021-01-02 00:00:00,SO,ESAVINGS ACCOUNT,300.0,,2589.51,Savings,Nottingham,UK
1886,2021-01-02 00:00:00,BP,SAVE THE CHANGE,2.44,,2889.51,Savings,Nottingham,UK
1887,2021-01-02 00:00:00,DEB,ORIENTAL MART HYDR,18.71,,2891.95,Groceries,Nottingham,UK
1888,2021-01-02 00:00:00,DEB,WWW.DOUGHNOTTSOFFI,10.05,,2910.66,Dine Out,Nottingham,UK
1889,2021-01-02 00:00:00,DEB,LIDL GB  NOTTINGHA,4.8,,2920.71,Groceries,Nottingham,UK
1890,29/01/2021,DEB,Trading212UK,1001.4,,2925.51,Investment,Nottingham,UK
1891,29/01/2021,DEB,SAINSBURYS S/MKT,15.6,,3926.91,Groceries,,
1892,29/01/2021,DD,TALKTALK LIMITED,19.95,,3942.51,Bills,Nottingham,UK
1893,28/01/2021,DEB,IKEA LTD SHOP ONLI,40.0,,3962.46,Other Shopping,,
1894,28/01/2021,FPO,ALICJA ALEXANDER,25.0,,4002.46,Services/Home Improvement,Nottingham,UK
1895,28/01/2021,FPO,PATRICIA A S LAW,220.0,,4027.46,Other Shopping,,
1896,28/01/2021,BP,SAVE THE CHANGE,1.13,,4247.46,Savings,Nottingham,UK
1897,28/01/2021,BGC,UNIV OF NOTTINGHAM,,3664.85,4248.59,Paycheck,Nottingham,UK
1898,27/01/2021,DEB,V Spot,23.87,,583.74,Dine Out,Nottingham,UK
1899,27/01/2021,DEB,WILKO RETAIL LIMIT,2.5,,607.61,Other Shopping,,
1900,27/01/2021,DEB,CO-OP GROUP 010161,1.5,,610.11,Groceries,,
1901,27/01/2021,BP,SAVE THE CHANGE,0.06,,611.61,Savings,Nottingham,UK
1902,26/01/2021,DEB,AMZNMktplace,47.95,,611.67,Amazon,Nottingham,UK
1903,26/01/2021,DEB,AMZNMktplace,13.99,,659.62,Amazon,Nottingham,UK
1904,26/01/2021,BP,SAVE THE CHANGE,0.35,,673.61,Savings,Nottingham,UK
1905,25/01/2021,FPO,ROBERT RECORD,75.0,,673.96,Others,Nottingham,UK
1906,25/01/2021,DEB,Trading212UK,200.0,,748.96,Investment,Nottingham,UK
1907,25/01/2021,DEB,TESCO STORES 5368,5.65,,948.96,Groceries,,
1908,25/01/2021,BP,SAVE THE CHANGE,2.94,,954.61,Savings,Nottingham,UK
1909,25/01/2021,DEB,ORIENTAL MART HYDR,26.55,,957.55,Groceries,Nottingham,UK
1910,25/01/2021,DEB,Audible UK,7.99,,984.1,Entertainment,Nottingham,UK
1911,25/01/2021,DEB,WWW.DOUGHNOTTSOFFI,6.8,,992.09,Dine Out,Nottingham,UK
1912,25/01/2021,DEB,TESCO STORE 2960,5.11,,998.89,Groceries,,
1913,25/01/2021,DEB,IKEA LTD SHOP ONLI,,65.0,1004.0,Supplementary Income,Nottingham,UK
1914,25/01/2021,FPI,YEWANDE MARIAN ADE,,400.0,939.0,Supplementary Income,Nottingham,UK
1915,25/01/2021,DEB,LIDL GB  NOTTINGHA,13.33,,539.0,Groceries,Nottingham,UK
1916,22/01/2021,DEB,IKEA LTD SHOP ONLI,65.0,,552.33,Other Shopping,,
1917,22/01/2021,DEB,Amazon.co.uk*MV5U4,6.95,,617.33,Amazon,Nottingham,UK
1918,22/01/2021,DEB,Amazon.co.uk*MV7U0,5.33,,624.28,Amazon,Nottingham,UK
1919,22/01/2021,BP,SAVE THE CHANGE,1.18,,629.61,Savings,Nottingham,UK
1920,21/01/2021,DEB,AMZNMktplace,60.47,,630.79,Amazon,Nottingham,UK
1921,21/01/2021,DEB,AMAZON.CO.UK*MV8UG,4.6,,691.26,Amazon,Nottingham,UK
1922,21/01/2021,DEB,TESCO STORES 5368,2.75,,695.86,Groceries,,
1923,21/01/2021,BP,SAVE THE CHANGE,0.55,,698.61,Savings,Nottingham,UK
1924,20/01/2021,DEB,TESCO STORES 5368,5.45,,699.16,Groceries,,
1925,20/01/2021,BP,SAVE THE CHANGE,0.24,,704.61,Savings,Nottingham,UK
1926,19/01/2021,DEB,LIDL GB  NOTTINGHA,10.76,,704.85,Groceries,Nottingham,UK
1927,19/01/2021,BP,SAVE THE CHANGE,0.65,,715.61,Savings,Nottingham,UK
1928,18/01/2021,DEB,STARBUCKS,7.35,,716.26,Dine Out,,
1929,18/01/2021,DD,VIRGIN MEDIA PYMTS,83.0,,723.61,Bills,Nottingham,UK
1930,18/01/2021,DD,O2,16.44,,806.61,Other Shopping,Nottingham,UK
1931,18/01/2021,BP,SAVE THE CHANGE,0.9,,823.05,Savings,Nottingham,UK
1932,18/01/2021,DEB,ORIENTAL MART HYDR,20.11,,823.95,Groceries,Nottingham,UK
1933,18/01/2021,DEB,AMZNMKTPLACE AMAZO,29.99,,844.06,Amazon,Nottingham,UK
1934,18/01/2021,FPO,ANTIGONI ABRAHMS,5.0,,874.05,Entertainment,London,UK
1935,15/01/2021,DEB,Trading212UK,200.0,,879.05,Investment,Nottingham,UK
1936,15/01/2021,BP,SAVE THE CHANGE,0.51,,1079.05,Savings,Nottingham,UK
1937,14/01/2021,DEB,HP INC UK LIMITED,3.49,,1079.56,Other Shopping,,
1938,14/01/2021,DEB,AMAZON.CO.UK*MV3ZD,15.0,,1083.05,Amazon,Nottingham,UK
1939,14/01/2021,FPI,YEWANDE MARIAN ADE,,400.0,1098.05,Supplementary Income,Nottingham,UK
1940,14/01/2021,BP,SAVE THE CHANGE,0.27,,698.05,Savings,Nottingham,UK
1941,13/01/2021,DEB,LIDL GB  NOTTINGHA,18.73,,698.32,Groceries,Nottingham,UK
1942,2021-12-01 00:00:00,FPO,ALICJA ALEXANDER,25.0,,717.05,Services/Home Improvement,Nottingham,UK
1943,2021-11-01 00:00:00,BP,SAVE THE CHANGE,1.85,,742.05,Savings,Nottingham,UK
1944,2021-11-01 00:00:00,DEB,ORIENTAL MART HYDR,20.39,,743.9,Groceries,Nottingham,UK
1945,2021-11-01 00:00:00,DEB,LIDL GB  NOTTINGHA,9.12,,764.29,Groceries,Nottingham,UK
1946,2021-11-01 00:00:00,FPO,ANTIGONI ABRAHMS,5.0,,773.41,Entertainment,London,UK
1947,2021-11-01 00:00:00,DEB,Trading212UK,300.0,,778.41,Investment,Nottingham,UK
1948,2021-11-01 00:00:00,DEB,AMZNMktplace,19.99,,1078.41,Amazon,Nottingham,UK
1949,2021-08-01 00:00:00,DEB,AMAZON.CO.UK*MJ513,27.65,,1098.4,Amazon,Nottingham,UK
1950,2021-08-01 00:00:00,BP,SAVE THE CHANGE,0.5,,1126.05,Savings,Nottingham,UK
1951,2021-07-01 00:00:00,DEB,LIDL GB  NOTTINGHA,13.5,,1126.55,Groceries,Nottingham,UK
1952,2021-06-01 00:00:00,FPO,MR J LITCHFIELD,370.0,,1140.05,Services,Nottingham,UK
1953,2021-06-01 00:00:00,BP,SAVE THE CHANGE,0.49,,1510.05,Savings,Nottingham,UK
1954,2021-05-01 00:00:00,DEP,CLUB LLOYDS WAIVED,,3.0,1510.54,Supplementary Income,Nottingham,UK
1955,2021-05-01 00:00:00,PAY,CLUB LLOYDS FEE,3.0,,1507.54,Bills,Nottingham,UK
1956,2021-05-01 00:00:00,DEB,Trading212UK,500.0,,1510.54,Investment,Nottingham,UK
1957,2021-05-01 00:00:00,DEB,LIDL GB  NOTTINGHA,9.51,,2010.54,Groceries,Nottingham,UK
1958,2021-04-01 00:00:00,,INTEREST (GROSS),,1.87,2020.05,Interest,Swansea,UK
1959,2021-04-01 00:00:00,DD,BARCLAYS UK MTGES,981.71,,2018.18,Bills,Nottingham,UK
1960,2021-04-01 00:00:00,SO,Q WANG,,1000.0,2999.89,Supplementary Income,Nottingham,UK
1961,2021-04-01 00:00:00,SO,ESAVINGS ACCOUNT,300.0,,1999.89,Savings,Nottingham,UK
1962,2021-04-01 00:00:00,BP,SAVE THE CHANGE,0.15,,2299.89,Savings,Nottingham,UK
1963,2021-04-01 00:00:00,DEB,IKEA LTD SHOP ONLI,296.0,,2300.04,Other Shopping,,
1964,31/12/2020,DEB,LIDL GB  NOTTINGHA,15.85,,2596.04,Groceries,Nottingham,UK
1965,31/12/2020,DD,TALKTALK LIMITED,18.64,,2611.89,Bills,Nottingham,UK
1966,31/12/2020,BP,SAVE THE CHANGE,0.67,,2630.53,Savings,Nottingham,UK
1967,30/12/2020,DEB,ORIENTAL MART HYDR,15.33,,2631.2,Groceries,Nottingham,UK
1968,30/12/2020,DEB,The Body Shop,15.0,,2646.53,Other Shopping,,
1969,30/12/2020,BP,SAVE THE CHANGE,0.16,,2661.53,Savings,Nottingham,UK
1970,29/12/2020,FPO,SALLY GOLDSTONE,198.0,,2661.69,Others,Nottingham,UK
1971,29/12/2020,DEB,AMZNMktplace,27.84,,2859.69,Amazon,Nottingham,UK
1972,29/12/2020,BP,SAVE THE CHANGE,2.64,,2887.53,Savings,Nottingham,UK
1973,29/12/2020,DEB,T4 TEA SALOON,13.6,,2890.17,Dine Out,Nottingham,UK
1974,29/12/2020,DEB,TESCO STORES 5368,5.2,,2903.77,Groceries,,
1975,29/12/2020,DEB,BLUEBIRD WHOLEFOOD,32.26,,2908.97,Groceries,Nottingham,UK
1976,24/12/2020,DEB,Trading212UK,250.0,,2941.23,Investment,Nottingham,UK
1977,24/12/2020,DEB,LIDL GB  NOTTINGHA,19.31,,3191.23,Groceries,Nottingham,UK
1978,24/12/2020,DEB,Audible UK,7.99,,3210.54,Entertainment,Nottingham,UK
1979,24/12/2020,BP,SAVE THE CHANGE,0.05,,3218.53,Savings,Nottingham,UK
1980,23/12/2020,DEB,Trading212UK,230.0,,3218.58,Investment,Nottingham,UK
1981,23/12/2020,DEB,AMZNMktplace,12.95,,3448.58,Amazon,Nottingham,UK
1982,23/12/2020,BP,SAVE THE CHANGE,0.48,,3461.53,Savings,Nottingham,UK
1983,22/12/2020,DEB,YANKEE STORE,9.72,,3462.01,Other Shopping,,
1984,22/12/2020,DEB,CAFFE NERO 650 NOT,5.8,,3471.73,Dine Out,Nottingham,UK
1985,22/12/2020,FPO,SHS,240.0,,3477.53,Home Improvement,Nottingham,UK
1986,22/12/2020,FPO,MR J LITCHFIELD,682.0,,3717.53,Services,Nottingham,UK
1987,22/12/2020,DD,THE RENEWABLE ENER,92.93,,4399.53,Bills,Nottingham,UK
1988,22/12/2020,BP,SAVE THE CHANGE,0.31,,4492.46,Savings,Nottingham,UK
1989,21/12/2020,DEB,AMZNMktplace,8.69,,4492.77,Amazon,Nottingham,UK
1990,21/12/2020,FPO,ANTIGONI ABRAHMS,5.0,,4501.46,Entertainment,London,UK
1991,21/12/2020,BP,SAVE THE CHANGE,3.55,,4506.46,Savings,Nottingham,UK
1992,21/12/2020,DEB,ORIENTAL MART HYDR,17.27,,4510.01,Groceries,Nottingham,UK
1993,21/12/2020,DEB,PP*DOUGHNOTTS,6.5,,4527.28,Dine Out,Nottingham,UK
1994,21/12/2020,DEB,WILKO RETAIL LIMIT,1.0,,4533.78,Other Shopping,,
1995,21/12/2020,DEB,Trading212UK,1000.0,,4534.78,Investment,Nottingham,UK
1996,21/12/2020,DEB,BLUEBIRD WHOLEFOOD,10.23,,5534.78,Groceries,Nottingham,UK
1997,21/12/2020,DEB,WILKO RETAIL LIMIT,10.0,,5545.01,Other Shopping,,
1998,21/12/2020,DEB,OZAN INTERNATIONAL,5.35,,5555.01,Groceries,Nottingham,UK
1999,18/12/2020,DEB,AMZNMKTPLACE AMAZO,8.1,,5560.36,Amazon,Nottingham,UK
2000,18/12/2020,BP,SAVE THE CHANGE,0.93,,5568.46,Savings,Nottingham,UK
2001,18/12/2020,BGC,NCC TRADE CRED NEW,,32.44,5569.39,Supplementary Income,Nottingham,UK
2002,17/12/2020,DEB,AMZNMktplace,24.07,,5536.95,Amazon,Nottingham,UK
2003,17/12/2020,BP,SAVE THE CHANGE,0.04,,5561.02,Savings,Nottingham,UK
2004,17/12/2020,BGC,UNIV OF NOTTINGHAM,,3665.25,5561.06,Paycheck,Nottingham,UK
2005,16/12/2020,DEB,AMZNMktplace,29.99,,1895.81,Amazon,Nottingham,UK
2006,16/12/2020,DEB,AMZNMktplace,15.97,,1925.8,Amazon,Nottingham,UK
2007,16/12/2020,DD,BARCLAYS UK MTGES,1005.95,,1941.77,Bills,Nottingham,UK
2008,16/12/2020,DD,O2,16.44,,2947.72,Other Shopping,Nottingham,UK
2009,16/12/2020,BP,SAVE THE CHANGE,0.26,,2964.16,Savings,Nottingham,UK
2010,15/12/2020,DEB,Trading212UK,750.0,,2964.42,Investment,Nottingham,UK
2011,15/12/2020,DEB,LIDL GB  NOTTINGHA,8.94,,3714.42,Groceries,Nottingham,UK
2012,15/12/2020,DEB,CAFFE NERO 650 NOT,3.8,,3723.36,Dine Out,Nottingham,UK
2013,15/12/2020,BP,SAVE THE CHANGE,0.52,,3727.16,Savings,Nottingham,UK
2014,14/12/2020,DEB,AMZNMktplace,9.99,,3727.68,Amazon,Nottingham,UK
2015,14/12/2020,DEB,HP INC UK LIMITED,3.49,,3737.67,Other Shopping,,
2016,14/12/2020,BP,SAVE THE CHANGE,3.38,,3741.16,Savings,Nottingham,UK
2017,14/12/2020,BGC,DEPOSIT PROTECTION,,950.0,3744.54,Supplementary Income,Nottingham,UK
2018,14/12/2020,BGC,SEVERN TRENT WATER,,17.6,2794.54,Supplementary Income,Nottingham,UK
2019,14/12/2020,DEB,AMZNMKTPLACE AMAZO,15.9,,2776.94,Amazon,Nottingham,UK
2020,14/12/2020,DEB,ORIENTAL MART HYDR,15.19,,2792.84,Groceries,Nottingham,UK
2021,14/12/2020,DEB,PP*DOUGHNOTTS,6.5,,2808.03,Dine Out,Nottingham,UK
2022,14/12/2020,DEB,STARBUCKS,3.95,,2814.53,Dine Out,,
2023,14/12/2020,DEB,AMZNMktplace,40.29,,2818.48,Amazon,Nottingham,UK
2024,14/12/2020,DEB,LIDL GB  NOTTINGHA,12.29,,2858.77,Groceries,Nottingham,UK
2025,14/12/2020,DEB,AMZNMktplace,5.69,,2871.06,Amazon,Nottingham,UK
2026,14/12/2020,DEB,APOLLO BLINDS,200.0,,2876.75,Home Improvement,Nottingham,UK
2027,2020-11-12 00:00:00,DEB,AMZNMktplace,2.81,,3076.75,Amazon,Nottingham,UK
2028,2020-11-12 00:00:00,FPI,HOWELLS LEGAL LIMI,,276.0,3079.56,Supplementary Income,Nottingham,UK
2029,2020-11-12 00:00:00,BP,SAVE THE CHANGE,0.74,,2803.56,Savings,Nottingham,UK
2030,2020-10-12 00:00:00,FPO,ANTIGONI ABRAHMS,5.0,,2804.3,Entertainment,London,UK
2031,2020-10-12 00:00:00,FPO,ROBERT RECORD,310.0,,2809.3,Others,Nottingham,UK
2032,2020-10-12 00:00:00,DEB,Trading212UK,250.0,,3119.3,Investment,Nottingham,UK
2033,2020-10-12 00:00:00,DEB,SHARIF AND SONS SU,34.26,,3369.3,Groceries,Derby,UK
2034,2020-10-12 00:00:00,BP,SAVE THE CHANGE,0.19,,3403.56,Savings,Nottingham,UK
2035,2020-09-12 00:00:00,DEB,LIDL GB  NOTTINGHA,33.81,,3403.75,Groceries,Nottingham,UK
2036,2020-09-12 00:00:00,DEB,THE LITTLE CARPET,,246.0,3437.56,Home Improvement,Nottingham,UK
2037,2020-09-12 00:00:00,BP,SAVE THE CHANGE,1.16,,3191.56,Savings,Nottingham,UK
2038,2020-08-12 00:00:00,DEB,AMZNMktplace,62.77,,3192.72,Amazon,Nottingham,UK
2039,2020-08-12 00:00:00,DEB,AMZNMKTPLACE AMAZO,6.07,,3255.49,Amazon,Nottingham,UK
2040,2020-07-12 00:00:00,BP,SAVE THE CHANGE,0.98,,3261.56,Savings,Nottingham,UK
2041,2020-07-12 00:00:00,DEB,Trading212UK,200.0,,3262.54,Investment,Nottingham,UK
2042,2020-07-12 00:00:00,DEB,AMZNMktplace,23.98,,3462.54,Amazon,Nottingham,UK
2043,2020-04-12 00:00:00,DEB,BLUEBIRD WHOLEFOOD,14.04,,3486.52,Groceries,Nottingham,UK
2044,2020-04-12 00:00:00,BP,SAVE THE CHANGE,0.92,,3500.56,Savings,Nottingham,UK
2045,2020-03-12 00:00:00,DEB,JUBILEE SHOP,5.08,,3501.48,Others,Nottingham,UK
2046,2020-03-12 00:00:00,BP,SAVE THE CHANGE,0.93,,3506.56,Savings,Nottingham,UK
2047,2020-02-12 00:00:00,DEP,CLUB LLOYDS WAIVED,,3.0,3507.49,Supplementary Income,Nottingham,UK
2048,2020-02-12 00:00:00,PAY,CLUB LLOYDS FEE,3.0,,3504.49,Bills,Nottingham,UK
2049,2020-02-12 00:00:00,DEB,Trading212UK,500.0,,3507.49,Investment,Nottingham,UK
2050,2020-02-12 00:00:00,DEB,LIDL GB  NOTTINGHA,12.07,,4007.49,Groceries,Nottingham,UK
2051,2020-01-12 00:00:00,,INTEREST (GROSS),,1.48,4019.56,Interest,Nottingham,UK
2052,2020-01-12 00:00:00,FPI,Q WANG,,1000.0,4018.08,Supplementary Income,Nottingham,UK
2053,2020-01-12 00:00:00,DD,NOTTM CITY COUNC,119.0,,3018.08,Bills,Nottingham,UK
2054,2020-01-12 00:00:00,DD,SEVERN TRENT WATER,16.43,,3137.08,Bills,Nottingham,UK
2055,2020-01-12 00:00:00,SO,ESAVINGS ACCOUNT,300.0,,3153.51,Savings,Nottingham,UK
2056,2020-01-12 00:00:00,BP,SAVE THE CHANGE,0.87,,3453.51,Savings,Nottingham,UK
2057,30/11/2020,DEB,SOLO GRANO,9.13,,3454.38,Dine Out,Nottingham,UK
2058,30/11/2020,FPO,ALICJA ALEXANDER,40.0,,3463.51,Services/Home Improvement,Nottingham,UK
2059,30/11/2020,BP,SAVE THE CHANGE,0.78,,3503.51,Savings,Nottingham,UK
2060,30/11/2020,DEB,Trading212UK,1000.0,,3504.29,Investment,Nottingham,UK
2061,30/11/2020,DEB,THE BIKE SHOP,13.98,,4504.29,Other Shopping,,
2062,30/11/2020,DEB,LIDL GB NOTTINGHAM,11.24,,4518.27,Groceries,Nottingham,UK
2063,30/11/2020,FPO,BORIS REMOVALS,650.0,,4529.51,Others,Nottingham,UK
2064,27/11/2020,DD,TALKTALK LIMITED,19.95,,5179.51,Bills,Nottingham,UK
2065,27/11/2020,BP,SAVE THE CHANGE,0.57,,5199.46,Savings,Nottingham,UK
2066,27/11/2020,BGC,UNIV OF NOTTINGHAM,,3665.25,5200.03,Paycheck,Nottingham,UK
2067,26/11/2020,DEB,JUBILEE SHOP,6.43,,1534.78,Others,Nottingham,UK
2068,26/11/2020,BP,SAVE THE CHANGE,1.98,,1541.21,Savings,Nottingham,UK
2069,25/11/2020,DEB,Trading212UK,1405.0,,1543.19,Investment,Nottingham,UK
2070,25/11/2020,DEB,AMZNMktplace,47.89,,2948.19,Amazon,Nottingham,UK
2071,25/11/2020,DEB,Trading212UK,25.0,,2996.08,Investment,Nottingham,UK
2072,25/11/2020,DEB,MOGAL EXPRESS,18.06,,3021.08,Groceries,Nottingham,UK
2073,25/11/2020,DEB,LIDL GB NOTTINGHAM,7.07,,3039.14,Groceries,Nottingham,UK
2074,25/11/2020,BP,SAVE THE CHANGE,0.03,,3046.21,Savings,Nottingham,UK
2075,25/11/2020,BGC,GOOGLE IRELAND,,61.65,3046.24,Supplementary Income,Nottingham,UK
2076,24/11/2020,DEB,AMZNMktplace,19.98,,2984.59,Amazon,Nottingham,UK
2077,24/11/2020,DEB,Audible UK,7.99,,3004.57,Entertainment,Nottingham,UK
2078,24/11/2020,FPI,IISL CLIENT GBP SE,,1405.69,3012.56,Supplementary Income,Nottingham,UK
2079,23/11/2020,BP,SAVE THE CHANGE,2.49,,1606.87,Savings,Nottingham,UK
2080,23/11/2020,DEB,ORIENTAL MART HYDR,10.52,,1609.36,Groceries,Nottingham,UK
2081,23/11/2020,DEB,STARBUCKS,7.4,,1619.88,Dine Out,,
2082,23/11/2020,DEB,LIDL GB NOTTINGHAM,6.42,,1627.28,Groceries,Nottingham,UK
2083,23/11/2020,DEB,PP*DOUGHNOTTS,5.5,,1633.7,Dine Out,Nottingham,UK
2084,23/11/2020,DEB,Trading212UK,738.0,,1639.2,Investment,Nottingham,UK
2085,23/11/2020,DEB,CO-OP GROUP 010661,11.78,,2377.2,Groceries,,
2086,23/11/2020,DEB,Amazon.co.uk*M703H,6.0,,2388.98,Amazon,Nottingham,UK
2087,23/11/2020,DEB,AMZNMKTPLACE AMAZO,45.89,,2394.98,Amazon,Nottingham,UK
2088,20/11/2020,DEB,Trading212UK,106.0,,2440.87,Investment,Nottingham,UK
2089,20/11/2020,FPI,IISL CLIENT GBP SE,,737.35,2546.87,Supplementary Income,Nottingham,UK
2090,20/11/2020,BP,SAVE THE CHANGE,0.76,,1809.52,Savings,Nottingham,UK
2091,19/11/2020,DEB,THE LITTLE CARPET,1174.0,,1810.28,Home Improvement,Nottingham,UK
2092,19/11/2020,DEB,AMZNMktplace,11.49,,2984.28,Amazon,Nottingham,UK
2093,19/11/2020,DEB,AMAZON.CO.UK*M75IR,6.0,,2995.77,Amazon,Nottingham,UK
2094,19/11/2020,DEB,ATRIUM JUBILEE 1,3.75,,3001.77,Dine Out,Nottingham,UK
2095,19/11/2020,FPI,IISL CLIENT GBP SE,,105.82,3005.52,Supplementary Income,Nottingham,UK
2096,19/11/2020,BP,SAVE THE CHANGE,1.35,,2899.7,Savings,Nottingham,UK
2097,18/11/2020,DEB,AMZNMktplace,31.98,,2901.05,Amazon,Nottingham,UK
2098,18/11/2020,DEB,AMZNMktplace,21.09,,2933.03,Amazon,Nottingham,UK
2099,18/11/2020,DEB,LIDL GB NOTTINGHAM,7.58,,2954.12,Groceries,Nottingham,UK
2100,18/11/2020,FPO,ALICJA ALEXANDER,25.0,,2961.7,Services/Home Improvement,Nottingham,UK
2101,17/11/2020,DEB,Trading212UK,860.0,,2986.7,Investment,Nottingham,UK
2102,17/11/2020,BP,SAVE THE CHANGE,1.06,,3846.7,Savings,Nottingham,UK
2103,16/11/2020,DEB,LIDL GB NOTTINGHAM,13.49,,3847.76,Groceries,Nottingham,UK
2104,16/11/2020,DEB,AMAZON.CO.UK*M7959,10.45,,3861.25,Amazon,Nottingham,UK
2105,16/11/2020,FPI,IISL CLIENT GBP SE,,100.0,3871.7,Supplementary Income,Nottingham,UK
2106,16/11/2020,FPI,IISL CLIENT GBP SE,,760.39,3771.7,Supplementary Income,Nottingham,UK
2107,16/11/2020,DD,O2,16.63,,3011.31,Other Shopping,Nottingham,UK
2108,16/11/2020,BP,SAVE THE CHANGE,2.85,,3027.94,Savings,Nottingham,UK
2109,16/11/2020,DEB,ORIENTAL MART HYDR,15.24,,3030.79,Groceries,Nottingham,UK
2110,16/11/2020,DEB,AMZNMktplace,13.73,,3046.03,Amazon,Nottingham,UK
2111,16/11/2020,DEB,HOLLAND & BARRETT,9.49,,3059.76,Groceries,,
2112,16/11/2020,DEB,ORIENTAL MART HYDR,0.79,,3069.25,Groceries,Nottingham,UK
2113,16/11/2020,DEB,Trading212UK,1333.0,,3070.04,Investment,Nottingham,UK
2114,16/11/2020,DEB,Trading212UK,100.0,,4403.04,Investment,Nottingham,UK
2115,16/11/2020,CPT,LNK 36 CLUMBER STR,40.0,,4503.04,Cash,Nottingham,UK
2116,13/11/2020,DEB,POST OFFICE COUNTE,47.99,,4543.04,Others,Nottingham,UK
2117,13/11/2020,DEB,AMZNMktplace,11.49,,4591.03,Amazon,Nottingham,UK
2118,13/11/2020,DEB,Amazon.co.uk*M768X,3.42,,4602.52,Amazon,Nottingham,UK
2119,13/11/2020,FPI,IISL CLIENT GBP SE,,1333.06,4605.94,Supplementary Income,Nottingham,UK
2120,13/11/2020,BP,SAVE THE CHANGE,0.03,,3272.88,Savings,Nottingham,UK
2121,2020-12-11 00:00:00,DEB,AMZNMktplace,16.97,,3272.91,Amazon,Nottingham,UK
2122,2020-11-11 00:00:00,FPI,ALHARBI M,,1000.0,3289.88,Supplementary Income,Nottingham,UK
2123,2020-11-11 00:00:00,BP,SAVE THE CHANGE,0.35,,2289.88,Savings,Nottingham,UK
2124,2020-10-11 00:00:00,DEB,LIDL GB NOTTINGHAM,33.65,,2290.23,Groceries,Nottingham,UK
2125,2020-10-11 00:00:00,BP,SAVE THE CHANGE,0.87,,2323.88,Savings,Nottingham,UK
2126,2020-09-11 00:00:00,DEB,Amazon.co.uk*M73C5,3.64,,2324.75,Amazon,Nottingham,UK
2127,2020-09-11 00:00:00,DEB,HOLLAND & BARRETT,5.49,,2328.39,Groceries,,
2128,2020-09-11 00:00:00,FPO,TRISTRAMS LETTINGS,825.0,,2333.88,Home Improvement,Nottingham,UK
2129,2020-09-11 00:00:00,BP,SAVE THE CHANGE,1.96,,3158.88,Savings,Nottingham,UK
2130,2020-09-11 00:00:00,DEB,ORIENTAL MART HYDR,14.74,,3160.84,Groceries,Nottingham,UK
2131,2020-09-11 00:00:00,DEB,LIDL GB NOTTINGHAM,11.07,,3175.58,Groceries,Nottingham,UK
2132,2020-09-11 00:00:00,DEB,STARBUCKS,3.95,,3186.65,Dine Out,,
2133,2020-09-11 00:00:00,DEB,POUNDSTRETCHER 63,2.28,,3190.6,Groceries,,
2134,2020-09-11 00:00:00,DEB,Trading212UK,1328.0,,3192.88,Investment,Nottingham,UK
2135,2020-09-11 00:00:00,DEB,Amazon.co.uk*M78CB,16.0,,4520.88,Amazon,Nottingham,UK
2136,2020-06-11 00:00:00,DEB,Audible UK,18.0,,4536.88,Entertainment,Nottingham,UK
2137,2020-06-11 00:00:00,DEB,AMAZON.CO.UK*M74IF,15.0,,4554.88,Amazon,Nottingham,UK
2138,2020-06-11 00:00:00,FPI,IISL CLIENT GBP SE,,1328.0,4569.88,Supplementary Income,Nottingham,UK
2139,2020-06-11 00:00:00,BP,SAVE THE CHANGE,0.5,,3241.88,Savings,Nottingham,UK
2140,2020-05-11 00:00:00,DEB,CO-OP GROUP 010661,9.5,,3242.38,Groceries,,
2141,2020-05-11 00:00:00,BP,SAVE THE CHANGE,0.46,,3251.88,Savings,Nottingham,UK
2142,2020-04-11 00:00:00,FPO,ALICJA ALEXANDER,25.0,,3252.34,Services/Home Improvement,Nottingham,UK
2143,2020-04-11 00:00:00,DEB,AMZNMktplace,19.54,,3277.34,Amazon,Nottingham,UK
2144,2020-04-11 00:00:00,DEB,Trading212UK,1.0,,3296.88,Investment,Nottingham,UK
2145,2020-04-11 00:00:00,BP,SAVE THE CHANGE,0.82,,3297.88,Savings,Nottingham,UK
2146,2020-03-11 00:00:00,DEP,CLUB LLOYDS WAIVED,,3.0,3298.7,Supplementary Income,Nottingham,UK
2147,2020-03-11 00:00:00,FPO,TAMBA TAM,10.0,,3295.7,Services,Nottingham,UK
2148,2020-03-11 00:00:00,PAY,CLUB LLOYDS FEE,3.0,,3305.7,Bills,Nottingham,UK
2149,2020-03-11 00:00:00,DEB,LIDL GB NOTTINGHAM,14.18,,3308.7,Groceries,Nottingham,UK
2150,2020-03-11 00:00:00,SO,TRISTRAMS LETTINGS,825.0,,3322.88,Home Improvement,Nottingham,UK
2151,2020-03-11 00:00:00,BP,SAVE THE CHANGE,0.58,,4147.88,Savings,Nottingham,UK
2152,2020-02-11 00:00:00,,INTEREST (GROSS),,1.71,4148.46,Interest,Nottingham,UK
2153,2020-02-11 00:00:00,DEB,CO-OP GROUP 010661,4.92,,4146.75,Groceries,,
2154,2020-02-11 00:00:00,DEB,PP*DOUGHNOTTS,5.5,,4151.67,Dine Out,Nottingham,UK
2155,2020-02-11 00:00:00,DD,NOTTM CITY COUNC,119.0,,4157.17,Bills,Nottingham,UK
2156,2020-02-11 00:00:00,DD,SEVERN TRENT WATER,25.7,,4276.17,Bills,Nottingham,UK
2157,2020-02-11 00:00:00,SO,ESAVINGS ACCOUNT,300.0,,4301.87,Savings,Nottingham,UK
2158,2020-02-11 00:00:00,BP,SAVE THE CHANGE,0.29,,4601.87,Savings,Nottingham,UK
2159,2020-02-11 00:00:00,DEB,ORIENTAL MART HYDR,14.72,,4602.16,Groceries,Nottingham,UK
2160,2020-02-11 00:00:00,DEB,T K MAXX,8.99,,4616.88,Other Shopping,,
2161,2020-02-11 00:00:00,DEB,CO-OP GROUP 010661,4.0,,4625.87,Groceries,,
2162,30/10/2020,DEB,Trading212UK,1100.0,,4629.87,Investment,Nottingham,UK
2163,30/10/2020,DEB,DANCE IN TIME BOUT,5.0,,5729.87,Clothes,,
2164,30/10/2020,BP,SAVE THE CHANGE,1.36,,5734.87,Savings,Nottingham,UK
2165,29/10/2020,DEB,Trading212UK,1756.0,,5736.23,Investment,Nottingham,UK
2166,29/10/2020,DEB,LIDL GB NOTTINGHAM,17.14,,7492.23,Groceries,Nottingham,UK
2167,29/10/2020,DEB,IZ *Secret Burger,8.5,,7509.37,Dine Out,Nottingham,UK
2168,29/10/2020,FPO,LAURA FOGLIATA,7.0,,7517.87,Services,Nottingham,UK
2169,29/10/2020,DD,THE RENEWABLE ENER,100.65,,7524.87,Bills,Nottingham,UK
2170,29/10/2020,BP,SAVE THE CHANGE,0.9,,7625.52,Savings,Nottingham,UK
2171,29/10/2020,BGC,UNIV OF NOTTINGHAM,,3664.85,7626.42,Paycheck,Nottingham,UK
2172,28/10/2020,DEB,AMZNMktplace,15.1,,3961.57,Amazon,Nottingham,UK
2173,28/10/2020,FPI,IISL CLIENT GBP SE,,1756.0,3976.67,Supplementary Income,Nottingham,UK
2174,27/10/2020,DD,TALKTALK LIMITED,19.95,,2220.67,Bills,Nottingham,UK
2175,27/10/2020,BP,SAVE THE CHANGE,0.45,,2240.62,Savings,Nottingham,UK
2176,26/10/2020,DEB,STARBUCKS,3.55,,2241.07,Dine Out,,
2177,26/10/2020,BP,SAVE THE CHANGE,2.15,,2244.62,Savings,Nottingham,UK
2178,26/10/2020,DEB,ORIENTAL MART HYDR,13.28,,2246.77,Groceries,Nottingham,UK
2179,26/10/2020,DEB,PP*DOUGHNOTTS,5.5,,2260.05,Dine Out,Nottingham,UK
2180,26/10/2020,DEB,Audible UK,7.99,,2265.55,Entertainment,Nottingham,UK
2181,26/10/2020,DEB,JUBILEE SHOP,5.08,,2273.54,Others,Nottingham,UK
2182,23/10/2020,DEB,Trading212UK,1326.0,,2278.62,Investment,Nottingham,UK
2183,23/10/2020,DEB,Amazon.co.uk*XB9UV,15.0,,3604.62,Amazon,Nottingham,UK
2184,23/10/2020,BP,SAVE THE CHANGE,0.14,,3619.62,Savings,Nottingham,UK
2185,22/10/2020,DEB,LIDL GB NOTTINGHAM,12.86,,3619.76,Groceries,Nottingham,UK
2186,22/10/2020,FPO,LAURA FOGLIATA,7.0,,3632.62,Services,Nottingham,UK
2187,22/10/2020,FPO,ALICJA ALEXANDER,25.0,,3639.62,Services/Home Improvement,Nottingham,UK
2188,22/10/2020,FPI,IISL CLIENT GBP SE,,1326.0,3664.62,Supplementary Income,Nottingham,UK
2189,22/10/2020,BP,SAVE THE CHANGE,0.51,,2338.62,Savings,Nottingham,UK
2190,21/10/2020,DEB,Amazon.co.uk*840ZD,3.49,,2339.13,Amazon,Nottingham,UK
2191,21/10/2020,BP,SAVE THE CHANGE,0.72,,2342.62,Savings,Nottingham,UK
2192,20/10/2020,DEB,CO-OP GROUP 010661,10.29,,2343.34,Groceries,,
2193,20/10/2020,DEB,AMZNMKTPLACE AMAZO,5.99,,2353.63,Amazon,Nottingham,UK
2194,20/10/2020,BP,SAVE THE CHANGE,0.53,,2359.62,Savings,Nottingham,UK
2195,19/10/2020,DEB,T K MAXX,11.97,,2360.15,Other Shopping,,
2196,19/10/2020,DEB,PP*DOUGHNOTTS,6.5,,2372.12,Dine Out,Nottingham,UK
2197,19/10/2020,BP,SAVE THE CHANGE,2.89,,2378.62,Savings,Nottingham,UK
2198,19/10/2020,DEB,Amazon.co.uk*EZ8KJ,16.0,,2381.51,Amazon,Nottingham,UK
2199,19/10/2020,DEB,SOLO GRANO,13.31,,2397.51,Dine Out,Nottingham,UK
2200,19/10/2020,DEB,ORIENTAL MART HYDR,10.38,,2410.82,Groceries,Nottingham,UK
2201,19/10/2020,DEB,JUBILEE SHOP,5.08,,2421.2,Others,Nottingham,UK
2202,19/10/2020,DEB,STARBUCKS,3.35,,2426.28,Dine Out,,
2203,16/10/2020,DEB,Trading212UK,926.0,,2429.63,Investment,Nottingham,UK
2204,16/10/2020,DEB,Trading212UK,75.0,,3355.63,Investment,Nottingham,UK
2205,16/10/2020,DEB,AMZNMktplace,33.99,,3430.63,Amazon,Nottingham,UK
2206,16/10/2020,DD,O2,17.18,,3464.62,Other Shopping,Nottingham,UK
2207,16/10/2020,BP,SAVE THE CHANGE,1.7,,3481.8,Savings,Nottingham,UK
2208,15/10/2020,FPO,LAURA FOGLIATA,3.0,,3483.5,Services,Nottingham,UK
2209,15/10/2020,FPO,LAURA FOGLIATA,7.0,,3486.5,Services,Nottingham,UK
2210,15/10/2020,DEB,LIDL GB NOTTINGHAM,21.11,,3493.5,Groceries,Nottingham,UK
2211,15/10/2020,DEB,JUBILEE SHOP,6.19,,3514.61,Others,Nottingham,UK
2212,15/10/2020,FPI,IISL CLIENT GBP SE,,926.0,3520.8,Supplementary Income,Nottingham,UK
2213,15/10/2020,BP,SAVE THE CHANGE,0.01,,2594.8,Savings,Nottingham,UK
2214,14/10/2020,DEB,AMZNMktplace,3.99,,2594.81,Amazon,Nottingham,UK
2215,14/10/2020,BP,SAVE THE CHANGE,0.01,,2598.8,Savings,Nottingham,UK
2216,13/10/2020,FPO,TAMBA TAM,20.0,,2598.81,Services,Nottingham,UK
2217,13/10/2020,DEB,AMZNMktplace,79.99,,2618.81,Amazon,Nottingham,UK
2218,13/10/2020,BP,SAVE THE CHANGE,1.8,,2698.8,Savings,Nottingham,UK
2219,2020-12-10 00:00:00,DEB,PP*DOUGHNOTTS,4.5,,2700.6,Dine Out,Nottingham,UK
2220,2020-12-10 00:00:00,DEB,CAFFE NERO NOTTING,3.3,,2705.1,Dine Out,Nottingham,UK
2221,2020-12-10 00:00:00,DEB,WILKO RETAIL LIMIT,2.4,,2708.4,Other Shopping,,
2222,2020-12-10 00:00:00,BP,SAVE THE CHANGE,0.96,,2710.8,Savings,Nottingham,UK
2223,2020-12-10 00:00:00,DEB,ORIENTAL MART HYDR,16.7,,2711.76,Groceries,Nottingham,UK
2224,2020-12-10 00:00:00,DEB,STARBUCKS,3.35,,2728.46,Dine Out,,
2225,2020-12-10 00:00:00,DEB,AMZNMKTPLACE AMAZO,11.99,,2731.81,Amazon,Nottingham,UK
2226,2020-09-10 00:00:00,BP,SAVE THE CHANGE,0.32,,2743.8,Savings,Nottingham,UK
2227,2020-08-10 00:00:00,FPO,ALICJA ALEXANDER,25.0,,2744.12,Services/Home Improvement,Nottingham,UK
2228,2020-08-10 00:00:00,FPO,LAURA FOGLIATA,7.0,,2769.12,Services,Nottingham,UK
2229,2020-08-10 00:00:00,DEB,LIDL GB NOTTINGHAM,17.68,,2776.12,Groceries,Nottingham,UK
2230,2020-07-10 00:00:00,DEB,Trading212UK,866.0,,2793.8,Investment,Nottingham,UK
2231,2020-06-10 00:00:00,FPO,TAMBA TAM,10.0,,3659.8,Services,Nottingham,UK
2232,2020-06-10 00:00:00,TFR,R LAWRENCE,200.0,,3669.8,,,
2233,2020-06-10 00:00:00,FPI,IISL CLIENT GBP SE,,866.0,3869.8,Supplementary Income,Nottingham,UK
2234,2020-06-10 00:00:00,BP,SAVE THE CHANGE,0.3,,3003.8,Savings,Nottingham,UK
2235,2020-05-10 00:00:00,DEB,AMZNMktplace,7.99,,3004.1,Amazon,Nottingham,UK
2236,2020-05-10 00:00:00,DEB,CO-OP GROUP 010661,4.71,,3012.09,Groceries,,
2237,2020-05-10 00:00:00,SO,TRISTRAMS LETTINGS,825.0,,3016.8,Home Improvement,Nottingham,UK
2238,2020-05-10 00:00:00,BP,SAVE THE CHANGE,1.09,,3841.8,Savings,Nottingham,UK
2239,2020-05-10 00:00:00,DEB,MOGAL EXPRESS,11.77,,3842.89,Groceries,Nottingham,UK
2240,2020-05-10 00:00:00,DEB,ORIENTAL MART HYDR,7.96,,3854.66,Groceries,Nottingham,UK
2241,2020-05-10 00:00:00,DEB,ONEBELOW,3.0,,3862.62,Other Shopping,,
2242,2020-05-10 00:00:00,CPT,LNK 49-51 CLUMBER,40.0,,3865.62,Cash,Nottingham,UK
2243,2020-02-10 00:00:00,DEP,CLUB LLOYDS WAIVED,,3.0,3905.62,Amazon,Nottingham,UK
2244,2020-02-10 00:00:00,PAY,CLUB LLOYDS FEE,3.0,,3902.62,Bills,Nottingham,UK
2245,2020-02-10 00:00:00,DEB,AMZNMktplace,46.18,,3905.62,Supplementary Income,Nottingham,UK
2246,2020-02-10 00:00:00,BP,SAVE THE CHANGE,0.23,,3951.8,Savings,Nottingham,UK
2247,2020-01-10 00:00:00,,INTEREST (GROSS),,2.39,3952.03,Interest,Nottingham,UK
2248,2020-01-10 00:00:00,FPO,LAURA FOGLIATA,7.0,,3949.64,Services,Nottingham,UK
2249,2020-01-10 00:00:00,DEB,LIDL GB NOTTINGHAM,26.77,,3956.64,Groceries,Nottingham,UK
2250,2020-01-10 00:00:00,DD,NOTTM CITY COUNC,119.0,,3983.41,Bills,Nottingham,UK
2251,2020-01-10 00:00:00,DD,SEVERN TRENT WATER,25.7,,4102.41,Bills,Nottingham,UK
2252,2020-01-10 00:00:00,SO,ESAVINGS ACCOUNT,300.0,,4128.11,Savings,Nottingham,UK
2253,2020-01-10 00:00:00,BP,SAVE THE CHANGE,0.2,,4428.11,Savings,Nottingham,UK
2254,30/09/2020,DEB,Trading212UK,1000.0,,4428.31,Investment,Nottingham,UK
2255,30/09/2020,DEB,AMZNMktplace,2.8,,5428.31,Amazon,Nottingham,UK
2256,30/09/2020,DD,TALKTALK LIMITED,19.95,,5431.11,Bills,Nottingham,UK
2257,30/09/2020,BP,SAVE THE CHANGE,0.32,,5451.06,Savings,Nottingham,UK
2258,29/09/2020,DEB,AMAZON.CO.UK*JX79R,5.68,,5451.38,Amazon,Nottingham,UK
2259,29/09/2020,FPO,TAMBA TAM,10.0,,5457.06,Services,Nottingham,UK
2260,29/09/2020,DD,THE RENEWABLE ENER,74.3,,5467.06,Bills,Nottingham,UK
2261,29/09/2020,BP,SAVE THE CHANGE,1.53,,5541.36,Savings,Nottingham,UK
2262,29/09/2020,BGC,UNIV OF NOTTINGHAM,,3665.25,5542.89,Paycheck,Nottingham,UK
2263,28/09/2020,DEB,GHOUSIA FOODS,13.28,,1877.64,Groceries,Nottingham,UK
2264,28/09/2020,DEB,CO-OP GROUP 010661,5.19,,1890.92,Groceries,,
2265,28/09/2020,BP,SAVE THE CHANGE,0.21,,1896.11,Savings,Nottingham,UK
2266,28/09/2020,DEB,Amazon.co.uk*KS7R7,6.0,,1896.32,Amazon,Nottingham,UK
2267,28/09/2020,DEB,THE ORGAN GRINDER,1.8,,1902.32,Dine Out,Nottingham,UK
2268,25/09/2020,DEB,AMZNMktplace,14.99,,1904.12,Amazon,Nottingham,UK
2269,25/09/2020,DEB,CO-OP GROUP 010661,7.0,,1919.11,Groceries,,
2270,25/09/2020,DEB,NBX*AT1.SPACE,175.0,,1926.11,Fitness,Nottingham,UK
2271,25/09/2020,BP,SAVE THE CHANGE,0.86,,2101.11,Savings,Nottingham,UK
2272,24/09/2020,FPO,LAURA FOGLIATA,7.0,,2101.97,Services,Nottingham,UK
2273,24/09/2020,DEB,LIDL GB NOTTINGHAM,12.15,,2108.97,Groceries,Nottingham,UK
2274,24/09/2020,DEB,Audible UK,7.99,,2121.12,Entertainment,Nottingham,UK
2275,24/09/2020,FPO,ALICJA ALEXANDER,25.0,,2129.11,Services/Home Improvement,Nottingham,UK
2276,22/09/2020,FPO,TAMBA TAM,10.0,,2154.11,Services,Nottingham,UK
2277,22/09/2020,FPO,EDWARD HANDS & LEW,350.0,,2164.11,,,
2278,22/09/2020,BP,SAVE THE CHANGE,0.02,,2514.11,Savings,Nottingham,UK
2279,21/09/2020,TFR,R LAWRENCE,300.0,,2514.13,,,
2280,21/09/2020,DEB,AMAZON.CO.UK*MY0NW,12.99,,2814.13,Amazon,Nottingham,UK
2281,21/09/2020,DEB,AMZNMKTPLACE AMAZO,10.99,,2827.12,Amazon,Nottingham,UK
2282,21/09/2020,FPI,ROTHERAS /CLI,,350.0,2838.11,Supplementary Income,Nottingham,UK
2283,21/09/2020,BP,SAVE THE CHANGE,1.39,,2488.11,Savings,Nottingham,UK
2284,21/09/2020,DEB,ORIENTAL MART HYDR,19.41,,2489.5,Groceries,Nottingham,UK
2285,21/09/2020,DEB,HOLLAND & BARRETT,10.98,,2508.91,Groceries,,
2286,21/09/2020,DEB,GHOUSIA FOODS,17.98,,2519.89,Groceries,Nottingham,UK
2287,21/09/2020,DEB,LIDL GB NOTTINGHAM,17.24,,2537.87,Groceries,Nottingham,UK
2288,17/09/2020,DEB,Trading212UK,420.0,,2555.11,Investment,Nottingham,UK
2289,17/09/2020,BP,SAVE THE CHANGE,0.26,,2975.11,Savings,Nottingham,UK
2290,16/09/2020,DEB,Trading212UK,391.0,,2975.37,Investment,Nottingham,UK
2291,16/09/2020,DEB,AMZNMktplace,11.99,,3366.37,Amazon,Nottingham,UK
2292,16/09/2020,DEB,CO-OP GROUP 010661,9.75,,3378.36,Groceries,,
2293,16/09/2020,DD,O2,16.63,,3388.11,Other Shopping,Nottingham,UK
2294,15/09/2020,FPO,TAMBA TAM,10.0,,3404.74,Services,Nottingham,UK
2295,15/09/2020,FPI,IISL CLIENT GBP SE,,391.0,3414.74,Supplementary Income,Nottingham,UK
2296,14/09/2020,FPO,LAURA FOGLIATA,7.0,,3023.74,Services,Nottingham,UK
2297,14/09/2020,BP,SAVE THE CHANGE,1.88,,3030.74,Savings,Nottingham,UK
2298,14/09/2020,DEB,HOLLAND & BARRETT,4.99,,3032.62,Groceries,,
2299,14/09/2020,DEB,ORIENTAL MART HYDR,2.5,,3037.61,Groceries,Nottingham,UK
2300,14/09/2020,DEB,AMZNMKTPLACE AMAZO,33.24,,3040.11,Amazon,Nottingham,UK
2301,14/09/2020,DEB,LIDL GB NOTTINGHAM,9.39,,3073.35,Groceries,Nottingham,UK
2302,2020-11-09 00:00:00,FPO,ALICJA ALEXANDER,25.0,,3082.74,Services/Home Improvement,Nottingham,UK
2303,2020-09-09 00:00:00,BP,SAVE THE CHANGE,0.16,,3107.74,Savings,Nottingham,UK
2304,2020-08-09 00:00:00,FPO,TAMBA TAM,10.0,,3107.9,Services,Nottingham,UK
2305,2020-08-09 00:00:00,DEB,LIDL GB NOTTINGHAM,15.87,,3117.9,Groceries,Nottingham,UK
2306,2020-08-09 00:00:00,DEB,T K MAXX,9.97,,3133.77,Other Shopping,,
2307,2020-08-09 00:00:00,BP,SAVE THE CHANGE,0.65,,3143.74,Savings,Nottingham,UK
2308,2020-07-09 00:00:00,DEB,AMZNMktplace,34.9,,3144.39,Amazon,Nottingham,UK
2309,2020-07-09 00:00:00,DEB,ORIENTAL MART HYDR,14.46,,3179.29,Groceries,Nottingham,UK
2310,2020-07-09 00:00:00,DEB,HOLLAND & BARRETT,4.99,,3193.75,Groceries,,
2311,2020-07-09 00:00:00,BP,SAVE THE CHANGE,0.86,,3198.74,Savings,Nottingham,UK
2312,2020-07-09 00:00:00,DEB,AMAZON.CO.UK*921DE,16.15,,3199.6,Amazon,Nottingham,UK
2313,2020-07-09 00:00:00,DEB,AMZNMktplace,10.99,,3215.75,Amazon,Nottingham,UK
2314,2020-04-09 00:00:00,BP,SAVE THE CHANGE,0.86,,3226.74,Savings,Nottingham,UK
2315,2020-03-09 00:00:00,DEB,LIDL GB NOTTINGHAM,16.14,,3227.6,Groceries,Nottingham,UK
2316,2020-03-09 00:00:00,DEB,AMZNMktplace,,5.11,3243.74,Supplementary Income,Nottingham,UK
2317,2020-03-09 00:00:00,SO,TRISTRAMS LETTINGS,825.0,,3238.63,Home Improvement,Nottingham,UK
2318,2020-03-09 00:00:00,BP,SAVE THE CHANGE,1.6,,4063.63,Savings,Nottingham,UK
2319,2020-02-09 00:00:00,DEP,CLUB LLOYDS WAIVED,,3.0,4065.23,Amazon,Nottingham,UK
2320,2020-02-09 00:00:00,PAY,CLUB LLOYDS FEE,3.0,,4062.23,Bills,Nottingham,UK
2321,2020-02-09 00:00:00,DEB,AMZNMktplace,31.29,,4065.23,Supplementary Income,Nottingham,UK
2322,2020-02-09 00:00:00,DEB,AMZNMktplace,5.11,,4096.52,Amazon,Nottingham,UK
2323,2020-02-09 00:00:00,BP,SAVE THE CHANGE,0.02,,4101.63,Savings,Nottingham,UK
2324,2020-01-09 00:00:00,,INTEREST (GROSS),,2.42,4101.65,Interest,Nottingham,UK
2325,2020-01-09 00:00:00,DEB,AMZNMktplace,43.99,,4099.23,Amazon,Nottingham,UK
2326,2020-01-09 00:00:00,DEB,AMZNMKTPLACE AMAZO,10.99,,4143.22,Amazon,Nottingham,UK
2327,2020-01-09 00:00:00,DD,NOTTM CITY COUNC,119.0,,4154.21,Bills,Nottingham,UK
2328,2020-01-09 00:00:00,DD,THE RENEWABLE ENER,68.52,,4273.21,Bills,Nottingham,UK
2329,2020-01-09 00:00:00,DD,SEVERN TRENT WATER,25.7,,4341.73,Bills,Nottingham,UK
2330,2020-01-09 00:00:00,SO,ESAVINGS ACCOUNT,300.0,,4367.43,Savings,Nottingham,UK
2331,2020-01-09 00:00:00,DEB,Trading212UK,1000.0,,4667.43,Investment,Nottingham,UK
2332,28/08/2020,FPO,TAMBA TAM,10.0,,5667.43,Services,Nottingham,UK
2333,28/08/2020,DD,UCU B ACCOUNT,24.76,,5677.43,Others,Nottingham,UK
2334,28/08/2020,DD,TALKTALK LIMITED,19.95,,5702.19,Bills,Nottingham,UK
2335,28/08/2020,DD,UCU B ACCOUNT,10.0,,5722.14,Others,Nottingham,UK
2336,28/08/2020,BP,SAVE THE CHANGE,0.01,,5732.14,Savings,Nottingham,UK
2337,27/08/2020,DEB,AMZNMktplace,25.99,,5732.15,Amazon,Nottingham,UK
2338,27/08/2020,BGC,UNIV OF NOTTINGHAM,,3665.25,5758.14,Paycheck,Nottingham,UK
2339,26/08/2020,FPO,ALICJA ALEXANDER,25.0,,2092.89,Services/Home Improvement,Nottingham,UK
2340,25/08/2020,DEB,LIDL GB NOTTINGHAM,9.0,,2117.89,Groceries,Nottingham,UK
2341,25/08/2020,BP,SAVE THE CHANGE,0.05,,2126.89,Savings,Nottingham,UK
2342,24/08/2020,DEB,AMZNMktplace,31.96,,2126.94,Amazon,Nottingham,UK
2343,24/08/2020,DEB,Audible UK,7.99,,2158.9,Entertainment,Nottingham,UK
2344,24/08/2020,BP,SAVE THE CHANGE,2.81,,2166.89,Savings,Nottingham,UK
2345,24/08/2020,DEB,ONEBELOW,11.16,,2169.7,Other Shopping,,
2346,24/08/2020,DEB,ORIENTAL MART HYDR,10.18,,2180.86,Groceries,Nottingham,UK
2347,24/08/2020,DEB,GREGGS PLC,1.0,,2191.04,Dine Out,,
2348,21/08/2020,DEB,LIDL GB NOTTINGHAM,29.59,,2192.04,Groceries,Nottingham,UK
2349,21/08/2020,DEB,AMZNMktplace,23.99,,2221.63,Amazon,Nottingham,UK
2350,21/08/2020,DEB,AMAZON.CO.UK*8L7P1,10.27,,2245.62,Amazon,Nottingham,UK
2351,21/08/2020,BP,SAVE THE CHANGE,0.26,,2255.89,Savings,Nottingham,UK
2352,20/08/2020,DEB,AMZNMktplace,12.74,,2256.15,Amazon,Nottingham,UK
2353,20/08/2020,DEB,NBX*AT1.SPACE,30.0,,2268.89,Fitness,Nottingham,UK
2354,20/08/2020,BP,SAVE THE CHANGE,0.5,,2298.89,Savings,Nottingham,UK
2355,19/08/2020,DEB,SUMUP  *THE PLANT,6.5,,2299.39,,,
2356,19/08/2020,BP,SAVE THE CHANGE,0.05,,2305.89,Savings,Nottingham,UK
2357,18/08/2020,DEB,AMZNMktplace,7.95,,2305.94,Amazon,Nottingham,UK
2358,18/08/2020,BP,SAVE THE CHANGE,0.32,,2313.89,Savings,Nottingham,UK
2359,17/08/2020,DEB,CAFFE NERO NOTTING,3.7,,2314.21,Dine Out,Nottingham,UK
2360,17/08/2020,DEB,WHEELHOUSE,13.98,,2317.91,Dine Out,Nottingham,UK
2361,17/08/2020,DD,O2,19.44,,2331.89,Other Shopping,Nottingham,UK
2362,17/08/2020,BP,SAVE THE CHANGE,1.52,,2351.33,Savings,Nottingham,UK
2363,17/08/2020,DEB,ORIENTAL MART HYDR,5.0,,2352.85,Groceries,Nottingham,UK
2364,17/08/2020,DEB,HOLLAND & BARRETT,4.0,,2357.85,Groceries,,
2365,17/08/2020,DEB,GREGGS PLC,2.0,,2361.85,Dine Out,,
2366,17/08/2020,DEB,AMZNMktplace,8.28,,2363.85,Amazon,Nottingham,UK
2367,17/08/2020,DEB,AMAZON.CO.UK*TU7DO,3.47,,2372.13,Amazon,Nottingham,UK
2368,14/08/2020,DEB,DANCE IN TIME BOUT,5.0,,2375.6,Clothes,,
2369,14/08/2020,DEB,AMZNMKTPLACE AMAZO,74.73,,2380.6,Amazon,Nottingham,UK
2370,14/08/2020,FPO,ALICJA ALEXANDER,25.0,,2455.33,Services/Home Improvement,Nottingham,UK
2371,14/08/2020,BP,SAVE THE CHANGE,1.04,,2480.33,Savings,Nottingham,UK
2372,13/08/2020,DEB,Trading212UK,250.0,,2481.37,Investment,Nottingham,UK
2373,13/08/2020,DEB,LIDL GB NOTTINGHAM,30.35,,2731.37,Groceries,Nottingham,UK
2374,13/08/2020,DEB,AMAZON.CO.UK*9S008,6.61,,2761.72,Amazon,Nottingham,UK
2375,2020-11-08 00:00:00,BP,SAVE THE CHANGE,0.95,,2768.33,Savings,Nottingham,UK
2376,2020-10-08 00:00:00,DEB,AMZNMktplace,9.05,,2769.28,Amazon,Nottingham,UK
2377,2020-10-08 00:00:00,BP,SAVE THE CHANGE,1.44,,2778.33,Savings,Nottingham,UK
2378,2020-10-08 00:00:00,DEB,ORIENTAL MART HYDR,11.49,,2779.77,Groceries,Nottingham,UK
2379,2020-10-08 00:00:00,DEB,HOLLAND & BARRETT,4.99,,2791.26,Groceries,,
2380,2020-10-08 00:00:00,DEB,STARBUCKS,3.5,,2796.25,Dine Out,,
2381,2020-10-08 00:00:00,DEB,AMZNMKTPLACE AMAZO,49.96,,2799.75,Amazon,Nottingham,UK
2382,2020-10-08 00:00:00,DEB,GHOUSIA FOODS,14.62,,2849.71,Groceries,Nottingham,UK
2383,2020-07-08 00:00:00,CPT,LNK PO MIDDLETONBO,40.0,,2864.33,Cash,Middleton,UK
2384,2020-07-08 00:00:00,DEB,DANCE IN TIME BOUT,5.0,,2904.33,Clothes,,
2385,2020-05-08 00:00:00,DEB,AMZ*momox co uk,,14.63,2909.33,Supplementary Income,Nottingham,UK
2386,2020-04-08 00:00:00,DEP,CLUB LLOYDS WAIVED,,3.0,2894.7,Supplementary Income,Nottingham,UK
2387,2020-04-08 00:00:00,PAY,CLUB LLOYDS FEE,3.0,,2891.7,Bills,Nottingham,UK
2388,2020-04-08 00:00:00,BP,SAVE THE CHANGE,0.15,,2894.7,Savings,Nottingham,UK
2389,2020-03-08 00:00:00,,INTEREST (GROSS),,2.25,2894.85,Interest,Nottingham,UK
2390,2020-03-08 00:00:00,DEB,COSTA COFFEE 43038,2.85,,2892.6,Dine Out,,
2391,2020-03-08 00:00:00,FPO,TAMBA TAM,10.0,,2895.45,Services,Nottingham,UK
2392,2020-03-08 00:00:00,DD,NOTTM CITY COUNC,119.0,,2905.45,Bills,Nottingham,UK
2393,2020-03-08 00:00:00,DD,SEVERN TRENT WATER,25.7,,3024.45,Bills,Nottingham,UK
2394,2020-03-08 00:00:00,SO,TRISTRAMS LETTINGS,825.0,,3050.15,Home Improvement,Nottingham,UK
2395,2020-03-08 00:00:00,SO,ESAVINGS ACCOUNT,300.0,,3875.15,Savings,Nottingham,UK
2396,2020-03-08 00:00:00,BP,SAVE THE CHANGE,1.16,,4175.15,Savings,Nottingham,UK
2397,2020-03-08 00:00:00,DEB,GHOUSIA FOODS,8.53,,4176.31,Groceries,Nottingham,UK
2398,2020-03-08 00:00:00,DEB,ORIENTAL MART HYDR,5.94,,4184.84,Groceries,Nottingham,UK
2399,2020-03-08 00:00:00,DEB,HOLLAND & BARRETT,4.99,,4190.78,Groceries,,
2400,2020-03-08 00:00:00,DEB,Trading212UK,1000.0,,4195.77,Investment,Nottingham,UK
2401,2020-03-08 00:00:00,DEB,AMZNMktplace,19.99,,5195.77,Amazon,Nottingham,UK
2402,2020-03-08 00:00:00,DEB,AMAZON.CO.UK AMAZO,,3.47,5215.76,Supplementary Income,Nottingham,UK
2403,31/07/2020,DEB,LIDL GB NOTTINGHAM,21.39,,5212.29,Groceries,Nottingham,UK
2404,31/07/2020,DD,UCU B ACCOUNT,24.76,,5233.68,Others,Nottingham,UK
2405,31/07/2020,BP,SAVE THE CHANGE,0.5,,5258.44,Savings,Nottingham,UK
2406,30/07/2020,DEB,Amazon.co.uk*7C4AV,4.5,,5258.94,Amazon,Nottingham,UK
2407,30/07/2020,DD,THE RENEWABLE ENER,23.25,,5263.44,Bills,Nottingham,UK
2408,30/07/2020,BGC,UNIV OF NOTTINGHAM,,3924.85,5286.69,Paycheck,Nottingham,UK
2409,29/07/2020,FPO,ALICJA ALEXANDER,25.0,,1361.84,Services/Home Improvement,Nottingham,UK
2410,29/07/2020,BP,SAVE THE CHANGE,0.18,,1386.84,Savings,Nottingham,UK
2411,28/07/2020,DEB,AMZNMktplace,10.82,,1387.02,Amazon,Nottingham,UK
2412,28/07/2020,BP,SAVE THE CHANGE,0.21,,1397.84,Savings,Nottingham,UK
2413,27/07/2020,DEB,AMZNMktplace,12.79,,1398.05,Amazon,Nottingham,UK
2414,27/07/2020,FPO,ROTHERAS SOLICITOR,350.0,,1410.84,Services,Nottingham,UK
2415,27/07/2020,DD,TALKTALK LIMITED,19.95,,1760.84,Bills,Nottingham,UK
2416,27/07/2020,BP,SAVE THE CHANGE,1.11,,1780.79,Savings,Nottingham,UK
2417,27/07/2020,DEB,ORIENTAL MART HYDR,6.85,,1781.9,Groceries,Nottingham,UK
2418,27/07/2020,DEB,CAFFE NERO 650 NOT,3.05,,1788.75,Dine Out,Nottingham,UK
2419,24/07/2020,DEB,Audible UK,7.99,,1791.8,Entertainment,Nottingham,UK
2420,24/07/2020,BP,SAVE THE CHANGE,0.04,,1799.79,Savings,Nottingham,UK
2421,23/07/2020,DEB,AMZNMktplace,44.98,,1799.83,Amazon,Nottingham,UK
2422,23/07/2020,DEB,AMZNMktplace,23.98,,1844.81,Amazon,Nottingham,UK
2423,22/07/2020,BP,SAVE THE CHANGE,0.62,,1868.79,Savings,Nottingham,UK
2424,21/07/2020,DEB,CO-OP GROUP 010661,22.38,,1869.41,Groceries,,
2425,21/07/2020,BP,SAVE THE CHANGE,0.97,,1891.79,Savings,Nottingham,UK
2426,20/07/2020,DEB,AMZNMKTPLACE AMAZO,18.99,,1892.76,Amazon,Nottingham,UK
2427,20/07/2020,DEB,AMZNMktplace,13.99,,1911.75,Amazon,Nottingham,UK
2428,20/07/2020,DEB,CAFFE NERO 650 NOT,3.05,,1925.74,Dine Out,Nottingham,UK
2429,20/07/2020,BP,SAVE THE CHANGE,1.49,,1928.79,Savings,Nottingham,UK
2430,20/07/2020,DEB,ORIENTAL MART HYDR,8.9,,1930.28,Groceries,Nottingham,UK
2431,20/07/2020,DEB,HOLLAND & BARRETT,6.49,,1939.18,Groceries,,
2432,20/07/2020,DEB,AMZNMktplace,45.49,,1945.67,Amazon,Nottingham,UK
2433,17/07/2020,DEB,AMZNMktplace,25.93,,1991.16,Amazon,Nottingham,UK
2434,17/07/2020,DEB,GHOUSIA FOODS,18.7,,2017.09,Groceries,Nottingham,UK
2435,17/07/2020,BP,SAVE THE CHANGE,1.11,,2035.79,Savings,Nottingham,UK
2436,16/07/2020,DEB,AMZNMktplace,22.62,,2036.9,Amazon,Nottingham,UK
2437,16/07/2020,DEB,GHOUSIA FOODS,21.27,,2059.52,Groceries,Nottingham,UK
2438,16/07/2020,DD,O2,16.44,,2080.79,Other Shopping,Nottingham,UK
2439,15/07/2020,FPO,ALICJA ALEXANDER,25.0,,2097.23,Services/Home Improvement,Nottingham,UK
2440,15/07/2020,BP,SAVE THE CHANGE,1.2,,2122.23,Savings,Nottingham,UK
2441,14/07/2020,DEB,Amazon.co.uk*K27LK,32.15,,2123.43,Amazon,Nottingham,UK
2442,14/07/2020,DEB,LIDL GB NOTTINGHAM,7.65,,2155.58,Groceries,Nottingham,UK
2443,14/07/2020,BP,SAVE THE CHANGE,0.01,,2163.23,Savings,Nottingham,UK
2444,13/07/2020,DEB,AMZNMKTPLACE AMAZO,17.99,,2163.24,Amazon,Nottingham,UK
2445,13/07/2020,BP,SAVE THE CHANGE,0.92,,2181.23,Savings,Nottingham,UK
2446,13/07/2020,DEB,Audible UK,18.0,,2182.15,Entertainment,Nottingham,UK
2447,13/07/2020,DEB,ORIENTAL MART HYDR,10.95,,2200.15,Groceries,Nottingham,UK
2448,13/07/2020,DEB,GREGGS PLC,2.0,,2211.1,Dine Out,,
2449,13/07/2020,DEB,LIDL GB NOTTINGHAM,15.14,,2213.1,Groceries,Nottingham,UK
2450,13/07/2020,DEB,AMAZON.CO.UK*HR2BI,12.99,,2228.24,Amazon,Nottingham,UK
2451,2020-09-07 00:00:00,FPO,SALLY GOLDSTONE,321.0,,2241.23,Others,Nottingham,UK
2452,2020-09-07 00:00:00,BP,SAVE THE CHANGE,0.07,,2562.23,Savings,Nottingham,UK
2453,2020-08-07 00:00:00,DEB,LIDL GB NOTTINGHAM,14.93,,2562.3,Groceries,Nottingham,UK
2454,2020-07-07 00:00:00,BP,SAVE THE CHANGE,0.47,,2577.23,Savings,Nottingham,UK
2455,2020-06-07 00:00:00,DEB,DISNEY STORE NOTTI,13.0,,2577.7,Other Shopping,Nottingham,UK
2456,2020-06-07 00:00:00,DEB,ONEBELOW,7.53,,2590.7,Other Shopping,,
2457,2020-06-07 00:00:00,DEB,GREGGS PLC,2.0,,2598.23,Dine Out,,
2458,2020-06-07 00:00:00,BP,SAVE THE CHANGE,1.07,,2600.23,Savings,Nottingham,UK
2459,2020-06-07 00:00:00,DEB,STARBUCKS,3.55,,2601.3,Dine Out,,
2460,2020-03-07 00:00:00,DEB,AMZNMktplace,31.97,,2604.85,Amazon,Nottingham,UK
2461,2020-03-07 00:00:00,DEB,LIDL GB NOTTINGHAM,20.62,,2636.82,Groceries,Nottingham,UK
2462,2020-03-07 00:00:00,DEB,AMZNMktplace,16.79,,2657.44,Amazon,Nottingham,UK
2463,2020-03-07 00:00:00,SO,TRISTRAMS LETTINGS,825.0,,2674.23,Home Improvement,Nottingham,UK
2464,2020-02-07 00:00:00,DEP,CLUB LLOYDS WAIVED,,3.0,3499.23,Supplementary Income,Nottingham,UK
2465,2020-02-07 00:00:00,PAY,CLUB LLOYDS FEE,3.0,,3496.23,Bills,Nottingham,UK
2466,2020-02-07 00:00:00,DEB,Trading212UK,1000.0,,3499.23,Investment,Nottingham,UK
2467,2020-02-07 00:00:00,BP,SAVE THE CHANGE,0.01,,4499.23,Savings,Nottingham,UK
2468,2020-01-07 00:00:00,,INTEREST (GROSS),,1.58,4499.24,Interest,Nottingham,UK
2469,2020-01-07 00:00:00,DEB,Trading212UK,6000.0,,4497.66,Investment,Nottingham,UK
2470,2020-01-07 00:00:00,DEB,AMZNMKTPLACE AMAZO,17.99,,10497.66,Amazon,Nottingham,UK
2471,2020-01-07 00:00:00,FPO,ALICJA ALEXANDER,25.0,,10515.65,Services/Home Improvement,Nottingham,UK
2472,2020-01-07 00:00:00,DD,NOTTM CITY COUNC,119.0,,10540.65,Bills,Nottingham,UK
2473,2020-01-07 00:00:00,DD,SEVERN TRENT WATER,25.7,,10659.65,Bills,Nottingham,UK
2474,2020-01-07 00:00:00,SO,ESAVINGS ACCOUNT,300.0,,10685.35,Savings,Nottingham,UK
2475,2020-01-07 00:00:00,BP,SAVE THE CHANGE,0.68,,10985.35,Savings,Nottingham,UK
2476,30/06/2020,DEB,Amazon.co.uk*7R62C,5.32,,10986.03,Amazon,Nottingham,UK
2477,30/06/2020,DD,UCU B ACCOUNT,24.76,,10991.35,Others,Nottingham,UK
2478,29/06/2020,DD,THE RENEWABLE ENER,88.54,,11016.11,Bills,Nottingham,UK
2479,29/06/2020,BP,SAVE THE CHANGE,1.52,,11104.65,Savings,Nottingham,UK
2480,29/06/2020,BGC,UNIV OF NOTTINGHAM,,9996.45,11106.17,Paycheck,Nottingham,UK
2481,29/06/2020,DEB,ONEBELOW,13.27,,1109.72,Other Shopping,,
2482,29/06/2020,DEB,HOLLAND & BARRETT,9.67,,1122.99,Groceries,,
2483,29/06/2020,DEB,ORIENTAL MART HYDR,2.6,,1132.66,Groceries,Nottingham,UK
2484,29/06/2020,DEB,GREGGS PLC,2.0,,1135.26,Dine Out,,
2485,26/06/2020,DEB,LIDL GB NOTTINGHAM,19.94,,1137.26,Groceries,Nottingham,UK
2486,26/06/2020,DD,TALKTALK LIMITED,11.85,,1157.2,Bills,Nottingham,UK
2487,26/06/2020,BP,SAVE THE CHANGE,0.91,,1169.05,Savings,Nottingham,UK
2488,25/06/2020,DEB,GHOUSIA FOODS,22.09,,1169.96,Groceries,Nottingham,UK
2489,25/06/2020,BP,SAVE THE CHANGE,0.01,,1192.05,Savings,Nottingham,UK
2490,24/06/2020,DEB,Audible UK,7.99,,1192.06,Entertainment,Nottingham,UK
2491,24/06/2020,BP,SAVE THE CHANGE,0.05,,1200.05,Savings,Nottingham,UK
2492,24/06/2020,BGC,GOOGLE IRELAND,,65.41,1200.1,Supplementary Income,Nottingham,UK
2493,23/06/2020,DEB,Amazon.co.uk*UK1KA,9.95,,1134.69,Amazon,Nottingham,UK
2494,23/06/2020,BP,SAVE THE CHANGE,0.61,,1144.64,Savings,Nottingham,UK
2495,22/06/2020,DEB,LIDL GB NOTTINGHAM,12.39,,1145.25,Groceries,Nottingham,UK
2496,22/06/2020,DEB,GREGGS PLC,3.0,,1157.64,Dine Out,,
2497,22/06/2020,BP,SAVE THE CHANGE,0.54,,1160.64,Savings,Nottingham,UK
2498,22/06/2020,DEB,T K MAXX,18.97,,1161.18,Other Shopping,,
2499,22/06/2020,CPT,LNK INTU VICTORIA,40.0,,1180.15,Cash,Nottingham,UK
2500,19/06/2020,FPO,ALICJA ALEXANDER,25.0,,1220.15,Services/Home Improvement,Nottingham,UK
2501,19/06/2020,DEB,AMZNMktplace,9.49,,1245.15,Amazon,Nottingham,UK
2502,19/06/2020,BP,SAVE THE CHANGE,0.49,,1254.64,Savings,Nottingham,UK
2503,18/06/2020,DEB,LIDL GB NOTTINGHAM,10.51,,1255.13,Groceries,Nottingham,UK
2504,18/06/2020,BP,SAVE THE CHANGE,1.22,,1265.64,Savings,Nottingham,UK
2505,17/06/2020,DEB,GHOUSIA FOODS,18.68,,1266.86,Groceries,Nottingham,UK
2506,17/06/2020,DEB,CO-OP GROUP 010661,11.1,,1285.54,Groceries,,
2507,16/06/2020,DD,O2,16.44,,1296.64,Other Shopping,Nottingham,UK
2508,16/06/2020,BP,SAVE THE CHANGE,0.15,,1313.08,Savings,Nottingham,UK
2509,15/06/2020,FPO,SALLY GOLDSTONE,155.0,,1313.23,Others,Nottingham,UK
2510,15/06/2020,DEB,AMZNMktplace,64.85,,1468.23,Amazon,Nottingham,UK
2511,15/06/2020,BP,SAVE THE CHANGE,1.47,,1533.08,Savings,Nottingham,UK
2512,15/06/2020,DEB,LIDL GB NOTTINGHAM,26.18,,1534.55,Groceries,Nottingham,UK
2513,2020-12-06 00:00:00,DEB,Amazon.co.uk*OS1EB,10.99,,1560.73,Amazon,Nottingham,UK
2514,2020-12-06 00:00:00,DEB,AMAZON.CO.UK*Z401P,14.36,,1571.72,Amazon,Nottingham,UK
2515,2020-11-06 00:00:00,BP,SAVE THE CHANGE,0.36,,1586.08,Savings,Nottingham,UK
2516,2020-10-06 00:00:00,DEB,GHOUSIA FOODS,13.64,,1586.44,Groceries,Nottingham,UK
2517,2020-10-06 00:00:00,BP,SAVE THE CHANGE,1.11,,1600.08,Savings,Nottingham,UK
2518,2020-09-06 00:00:00,,INTEREST (GROSS),,3.17,1601.19,Interest,Nottingham,UK
2519,2020-09-06 00:00:00,DEB,AMZNMktplace,177.87,,1598.02,Amazon,Nottingham,UK
2520,2020-09-06 00:00:00,DEB,AMZNMKTPLACE AMAZO,3.02,,1775.89,Amazon,Nottingham,UK
2521,2020-08-06 00:00:00,BP,SAVE THE CHANGE,1.14,,1778.91,Savings,Nottingham,UK
2522,2020-08-06 00:00:00,DEB,ORIENTAL MART HYDR,26.23,,1780.05,Groceries,Nottingham,UK
2523,2020-08-06 00:00:00,DEB,LIDL GB NOTTINGHAM,24.63,,1806.28,Groceries,Nottingham,UK
2524,2020-05-06 00:00:00,DEB,Trading212UK,520.0,,1830.91,Investment,Nottingham,UK
2525,2020-05-06 00:00:00,BGC,INFORMA UK LTD,,75.0,2350.91,Supplementary Income,Nottingham,UK
2526,2020-04-06 00:00:00,DEB,FARM FRESH NOTTING,18.0,,2275.91,Dine Out,Nottingham,UK
2527,2020-04-06 00:00:00,BP,SAVE THE CHANGE,0.64,,2293.91,Savings,Nottingham,UK
2528,2020-03-06 00:00:00,DEB,Trading212UK,320.0,,2294.55,Investment,Nottingham,UK
2529,2020-03-06 00:00:00,DEB,GHOUSIA FOODS,29.36,,2614.55,Groceries,Nottingham,UK
2530,2020-03-06 00:00:00,SO,TRISTRAMS LETTINGS,825.0,,2643.91,Home Improvement,Nottingham,UK
2531,2020-03-06 00:00:00,BP,SAVE THE CHANGE,0.01,,3468.91,Savings,Nottingham,UK
2532,2020-02-06 00:00:00,DEP,CLUB LLOYDS WAIVED,,3.0,3468.92,Supplementary Income,Nottingham,UK
2533,2020-02-06 00:00:00,PAY,CLUB LLOYDS FEE,3.0,,3465.92,Bills,Nottingham,UK
2534,2020-02-06 00:00:00,DEB,Trading212UK,1000.0,,3468.92,Investment,Nottingham,UK
2535,2020-02-06 00:00:00,DEB,AMZNMktplace,15.99,,4468.92,Amazon,Nottingham,UK
2536,2020-02-06 00:00:00,FPO,ALICJA ALEXANDER,25.0,,4484.91,Services/Home Improvement,Nottingham,UK
2537,2020-01-06 00:00:00,DD,NOTTM CITY COUNC,119.0,,4509.91,Bills,Nottingham,UK
2538,2020-01-06 00:00:00,DD,THE RENEWABLE ENER,29.55,,4628.91,Bills,Nottingham,UK
2539,2020-01-06 00:00:00,DD,SEVERN TRENT WATER,25.77,,4658.46,Bills,Nottingham,UK
2540,2020-01-06 00:00:00,SO,ESAVINGS ACCOUNT,300.0,,4684.23,Savings,Nottingham,UK
2541,2020-01-06 00:00:00,BP,SAVE THE CHANGE,2.41,,4984.23,Savings,Nottingham,UK
2542,29/05/2020,DEB,Trading212UK,1000.0,,4986.64,Investment,Nottingham,UK
2543,29/05/2020,DEB,LIDL GB NOTTINGHAM,23.31,,5986.64,Groceries,Nottingham,UK
2544,29/05/2020,DEB,AMZNMKTPLACE AMAZO,20.08,,6009.95,Amazon,Nottingham,UK
2545,29/05/2020,DEB,AMAZON.CO.UK*BZ9XP,9.2,,6030.03,Amazon,Nottingham,UK
2546,29/05/2020,DD,UCU B ACCOUNT,24.76,,6039.23,Others,Nottingham,UK
2547,28/05/2020,BP,SAVE THE CHANGE,1.29,,6063.99,Savings,Nottingham,UK
2548,28/05/2020,BGC,UNIV OF NOTTINGHAM,,3578.45,6065.28,Paycheck,Nottingham,UK
2549,27/05/2020,DEB,AMZN Mktp US*M74TR,10.56,,2486.83,Amazon,Nottingham,UK
2550,27/05/2020,DEB,CO-OP GROUP 010661,7.65,,2497.39,Groceries,,
2551,27/05/2020,DEB,Amazon.co.uk*EE5SK,2.5,,2505.04,Amazon,Nottingham,UK
2552,26/05/2020,BP,SAVE THE CHANGE,1.23,,2507.54,Savings,Nottingham,UK
2553,26/05/2020,DEB,CO-OP GROUP 010661,14.25,,2508.77,Groceries,,
2554,26/05/2020,DEB,Audible UK,7.99,,2523.02,Entertainment,Nottingham,UK
2555,26/05/2020,DEB,GHOUSIA FOODS,13.53,,2531.01,Groceries,Nottingham,UK
2556,22/05/2020,FPO,SALLY GOLDSTONE,45.0,,2544.54,Others,Nottingham,UK
2557,22/05/2020,BP,SAVE THE CHANGE,0.1,,2589.54,Savings,Nottingham,UK
2558,21/05/2020,DEB,AMZNMKTPLACE AMAZO,14.9,,2589.64,Amazon,Nottingham,UK
2559,21/05/2020,FPO,ALICJA ALEXANDER,25.0,,2604.54,Services/Home Improvement,Nottingham,UK
2560,19/05/2020,DEB,Trading212UK,500.0,,2629.54,Investment,Nottingham,UK
2561,19/05/2020,BP,SAVE THE CHANGE,0.34,,3129.54,Savings,Nottingham,UK
2562,18/05/2020,DEB,HOLLAND & BARRETT,21.66,,3129.88,Groceries,,
2563,18/05/2020,DD,O2,16.44,,3151.54,Other Shopping,Nottingham,UK
2564,18/05/2020,BP,SAVE THE CHANGE,0.41,,3167.98,Savings,Nottingham,UK
2565,18/05/2020,DEB,ORIENTAL MART HYDR,19.84,,3168.39,Groceries,Nottingham,UK
2566,18/05/2020,DEB,Amazon.co.uk*W52CT,10.75,,3188.23,Amazon,Nottingham,UK
2567,18/05/2020,CPT,LOYD LOYD LOWER PA,40.0,,3198.98,Cash,Nottingham,UK
2568,15/05/2020,DEB,AMZNMKTPLACE AMAZO,,12.14,3238.98,Supplementary Income,Nottingham,UK
2569,15/05/2020,BP,SAVE THE CHANGE,1.51,,3226.84,Savings,Nottingham,UK
2570,14/05/2020,DEB,AMZN Mktp US*MC8CK,25.35,,3228.35,Amazon,Nottingham,UK
2571,14/05/2020,DEB,AMZNMKTPLACE AMAZO,12.14,,3253.7,Amazon,Nottingham,UK
2572,14/05/2020,BP,SAVE THE CHANGE,0.42,,3265.84,Savings,Nottingham,UK
2573,13/05/2020,DEB,CO-OP GROUP 010661,12.58,,3266.26,Groceries,,
2574,13/05/2020,DEB,Trading212UK,500.0,,3278.84,Investment,Nottingham,UK
2575,2020-11-05 00:00:00,BP,SAVE THE CHANGE,1.56,,3778.84,Savings,Nottingham,UK
2576,2020-11-05 00:00:00,DEB,AMAZON.CO.UK AMAZO,,23.96,3780.4,Supplementary Income,Nottingham,UK
2577,2020-11-05 00:00:00,DEB,AMZ*Amazon.co.uk,,23.96,3756.44,Supplementary Income,Nottingham,UK
2578,2020-11-05 00:00:00,DEB,AMZNMktplace,68.46,,3732.48,Amazon,Nottingham,UK
2579,2020-11-05 00:00:00,DEB,GHOUSIA FOODS,39.03,,3800.94,Groceries,Nottingham,UK
2580,2020-11-05 00:00:00,DEB,AMZNMktplace,7.95,,3839.97,Amazon,Nottingham,UK
2581,2020-07-05 00:00:00,BP,SAVE THE CHANGE,0.67,,3847.92,Savings,Nottingham,UK
2582,2020-06-05 00:00:00,DEB,AMZNMKTPLACE AMAZO,23.71,,3848.59,Amazon,Nottingham,UK
2583,2020-06-05 00:00:00,DEB,LIDL GB NOTTINGHAM,22.62,,3872.3,Groceries,Nottingham,UK
2584,2020-06-05 00:00:00,DEB,AMAZON.CO.UK*WS0FS,15.0,,3894.92,Amazon,Nottingham,UK
2585,2020-05-05 00:00:00,FPO,ALICJA ALEXANDER,25.0,,3909.92,Services/Home Improvement,Nottingham,UK
2586,2020-05-05 00:00:00,BP,SAVE THE CHANGE,0.06,,3934.92,Savings,Nottingham,UK
2587,2020-04-05 00:00:00,DEP,CLUB LLOYDS WAIVED,,3.0,3934.98,Amazon,Nottingham,UK
2588,2020-04-05 00:00:00,PAY,CLUB LLOYDS FEE,3.0,,3931.98,Bills,Nottingham,UK
2589,2020-04-05 00:00:00,DEB,AMZNMKTPLACE AMAZO,23.94,,3934.98,Supplementary Income,Nottingham,UK
2590,2020-04-05 00:00:00,SO,TRISTRAMS LETTINGS,825.0,,3958.92,Home Improvement,Nottingham,UK
2591,2020-04-05 00:00:00,BP,SAVE THE CHANGE,2.07,,4783.92,Savings,Nottingham,UK
2592,2020-04-05 00:00:00,DEB,AMZNMktplace,7.57,,4785.99,Amazon,Nottingham,UK
2593,2020-04-05 00:00:00,DEB,AMZNMKTPLACE AMAZO,14.45,,4793.56,Amazon,Nottingham,UK
2594,2020-04-05 00:00:00,DEB,AMZNMKTPLACE AMAZO,2.82,,4808.01,Amazon,Nottingham,UK
2595,2020-04-05 00:00:00,DEB,AMZNMKTPLACE AMAZO,14.1,,4810.83,Amazon,Nottingham,UK
2596,2020-04-05 00:00:00,DEB,AMZNMKTPLACE AMAZO,12.99,,4824.93,Amazon,Nottingham,UK
2597,2020-01-05 00:00:00,,INTEREST (GROSS),,3.36,4837.92,Interest,Nottingham,UK
2598,2020-01-05 00:00:00,DEB,Trading212UK,1000.0,,4834.56,Investment,Nottingham,UK
2599,2020-01-05 00:00:00,DD,NOTTM CITY COUNC,119.0,,5834.56,Bills,Nottingham,UK
2600,2020-01-05 00:00:00,DD,SEVERN TRENT WATER,15.37,,5953.56,Bills,Nottingham,UK
2601,2020-01-05 00:00:00,SO,ESAVINGS ACCOUNT,300.0,,5968.93,Savings,Nottingham,UK
2602,30/04/2020,DD,UCU B ACCOUNT,24.76,,6268.93,Others,Nottingham,UK
2603,29/04/2020,BP,SAVE THE CHANGE,0.01,,6293.69,Savings,Nottingham,UK
2604,29/04/2020,BGC,UNIV OF NOTTINGHAM,,3578.85,6293.7,Paycheck,Nottingham,UK
2605,28/04/2020,DEB,AMZNMktplace,26.99,,2714.85,Amazon,Nottingham,UK
2606,28/04/2020,BP,SAVE THE CHANGE,0.05,,2741.84,Savings,Nottingham,UK
2607,27/04/2020,DEB,LIDL GB NOTTINGHAM,18.95,,2741.89,Groceries,Nottingham,UK
2608,27/04/2020,BP,SAVE THE CHANGE,0.01,,2760.84,Savings,Nottingham,UK
2609,27/04/2020,DEB,WWW.III.CO.UK DE,40.0,,2760.85,Investment,Nottingham,UK
2610,24/04/2020,DEB,AMAZON.CO.UK*PR1TB,79.0,,2800.85,Amazon,Nottingham,UK
2611,24/04/2020,DEB,Audible UK,7.99,,2879.85,Entertainment,Nottingham,UK
2612,23/04/2020,FPO,ALICJA ALEXANDER,25.0,,2887.84,Services/Home Improvement,Nottingham,UK
2613,23/04/2020,BP,SAVE THE CHANGE,0.04,,2912.84,Savings,Nottingham,UK
2614,22/04/2020,DEB,Amazon.co.uk*SE9IM,23.96,,2912.88,Amazon,Nottingham,UK
2615,22/04/2020,BP,SAVE THE CHANGE,0.7,,2936.84,Savings,Nottingham,UK
2616,21/04/2020,DEB,LIDL GB NOTTINGHAM,25.3,,2937.54,Groceries,Nottingham,UK
2617,20/04/2020,BP,SAVE THE CHANGE,1.33,,2962.84,Savings,Nottingham,UK
2618,20/04/2020,DEB,GHOUSIA FOODS,22.69,,2964.17,Groceries,Nottingham,UK
2619,20/04/2020,DEB,ECOTRICITY,126.81,,2986.86,Home Improvement,Nottingham,UK
2620,20/04/2020,DEB,AMZNMKTPLACE AMAZO,3.58,,3113.67,Amazon,Nottingham,UK
2621,17/04/2020,DEB,AMZNMKTPLACE AMAZO,2.59,,3117.25,Amazon,Nottingham,UK
2622,17/04/2020,BP,SAVE THE CHANGE,0.75,,3119.84,Savings,Nottingham,UK
2623,16/04/2020,DEB,AMZNMKTPLACE AMAZO,61.25,,3120.59,Amazon,Nottingham,UK
2624,16/04/2020,DD,O2,19.59,,3181.84,Other Shopping,Nottingham,UK
2625,16/04/2020,BP,SAVE THE CHANGE,0.82,,3201.43,Savings,Nottingham,UK
2626,15/04/2020,DEB,WWW.SO.ENERGY,199.56,,3202.25,Bills,Nottingham,UK
2627,15/04/2020,DEB,AMZNMKTPLACE AMAZO,25.0,,3401.81,Amazon,Nottingham,UK
2628,15/04/2020,DEB,LIDL GB NOTTINGHAM,18.62,,3426.81,Groceries,Nottingham,UK
2629,14/04/2020,DD,VIRGIN MEDIA PYMTS,14.43,,3445.43,Bills,Nottingham,UK
2630,14/04/2020,BP,SAVE THE CHANGE,1.63,,3459.86,Savings,Nottingham,UK
2631,14/04/2020,DEB,AMAZON.CO.UK*7V4G4,38.32,,3461.49,Amazon,Nottingham,UK
2632,14/04/2020,DEB,Audible UK,8.2,,3499.81,Entertainment,Nottingham,UK
2633,14/04/2020,DEB,WWW.III.CO.UK DE,1000.0,,3508.01,Investment,Nottingham,UK
2634,14/04/2020,DEB,WWW.III.CO.UK DE,500.0,,4508.01,Investment,Nottingham,UK
2635,2020-09-04 00:00:00,DEB,WWW.III.CO.UK DE,1000.0,,5008.01,Investment,Nottingham,UK
2636,2020-09-04 00:00:00,DEB,LIDL GB NOTTINGHAM,26.85,,6008.01,Groceries,Nottingham,UK
2637,2020-09-04 00:00:00,BP,SAVE THE CHANGE,0.36,,6034.86,Savings,Nottingham,UK
2638,2020-08-04 00:00:00,DEB,WWW.III.CO.UK DE,2000.0,,6035.22,Investment,Nottingham,UK
2639,2020-08-04 00:00:00,DEB,AMZNMktplace,26.72,,8035.22,Amazon,Nottingham,UK
2640,2020-08-04 00:00:00,DEB,AMZNMktplace,25.92,,8061.94,Amazon,Nottingham,UK
2641,2020-07-04 00:00:00,FPO,ALICJA ALEXANDER,25.0,,8087.86,Services/Home Improvement,Nottingham,UK
2642,2020-07-04 00:00:00,BP,SAVE THE CHANGE,0.05,,8112.86,Savings,Nottingham,UK
2643,2020-06-04 00:00:00,DEB,GHOUSIA FOODS,30.95,,8112.91,Groceries,Nottingham,UK
2644,2020-06-04 00:00:00,BP,SAVE THE CHANGE,2.4,,8143.86,Savings,Nottingham,UK
2645,2020-06-04 00:00:00,DEB,AMAZON.CO.UK*6Z8T6,25.76,,8146.26,Amazon,Nottingham,UK
2646,2020-06-04 00:00:00,DEB,AMZNMKTPLACE AMAZO,11.15,,8172.02,Amazon,Nottingham,UK
2647,2020-06-04 00:00:00,CPT,LNK UNIVERSITY PAR,40.0,,8183.17,Cash,Nottingham,UK
2648,2020-06-04 00:00:00,DEB,AMZNMKTPLACE AMAZO,30.25,,8223.17,Amazon,Nottingham,UK
2649,2020-06-04 00:00:00,DEB,LIDL GB NOTTINGHAM,25.44,,8253.42,Groceries,Nottingham,UK
2650,2020-03-04 00:00:00,SO,TRISTRAMS LETTINGS,825.0,,8278.86,Home Improvement,Nottingham,UK
2651,2020-02-04 00:00:00,DEP,CLUB LLOYDS WAIVED,,3.0,9103.86,Supplementary Income,Nottingham,UK
2652,2020-02-04 00:00:00,PAY,CLUB LLOYDS FEE,3.0,,9100.86,Bills,Nottingham,UK
2653,2020-02-04 00:00:00,BP,SAVE THE CHANGE,0.01,,9103.86,Savings,Nottingham,UK
2654,2020-01-04 00:00:00,,INTEREST (GROSS),,4.71,9103.87,Interest,Nottingham,UK
2655,2020-01-04 00:00:00,DEB,AMZNMktplace,21.99,,9099.16,Amazon,Nottingham,UK
2656,2020-01-04 00:00:00,DD,NOTTM CITY COUNC,115.47,,9121.15,Bills,Nottingham,UK
2657,2020-01-04 00:00:00,DD,SEVERN TRENT WATER,15.31,,9236.62,Bills,Nottingham,UK
2658,2020-01-04 00:00:00,SO,ESAVINGS ACCOUNT,300.0,,9251.93,Savings,Nottingham,UK
2659,31/03/2020,DD,UCU B ACCOUNT,24.76,,9551.93,Others,Nottingham,UK
2660,31/03/2020,DD,TALKTALK LIMITED,19.95,,9576.69,Bills,Nottingham,UK
2661,30/03/2020,BP,SAVE THE CHANGE,0.15,,9596.64,Savings,Nottingham,UK
2662,30/03/2020,BGC,UNIV OF NOTTINGHAM,,4336.21,9596.79,Paycheck,Nottingham,UK
2663,30/03/2020,DEB,AMZNMktplace,21.0,,5260.58,Amazon,Nottingham,UK
2664,30/03/2020,DEB,LIDL GB NOTTINGHAM,20.85,,5281.58,Groceries,Nottingham,UK
2665,27/03/2020,BP,SAVE THE CHANGE,0.87,,5302.43,Savings,Nottingham,UK
2666,26/03/2020,DEB,LIDL GB NOTTINGHAM,8.24,,5303.3,Groceries,Nottingham,UK
2667,26/03/2020,DEB,AMAZON.CO.UK*MC22D,7.89,,5311.54,Amazon,Nottingham,UK
2668,25/03/2020,BP,SAVE THE CHANGE,1.24,,5319.43,Savings,Nottingham,UK
2669,24/03/2020,DEB,AMZNMktplace,33.98,,5320.67,Amazon,Nottingham,UK
2670,24/03/2020,DEB,ORIENTAL MART,19.6,,5354.65,Groceries,Nottingham,UK
2671,24/03/2020,DEB,LIDL GB NOTTINGHAM,14.19,,5374.25,Groceries,Nottingham,UK
2672,24/03/2020,DEB,Audible UK,7.99,,5388.44,Entertainment,Nottingham,UK
2673,24/03/2020,FPO,ALICJA ALEXANDER,25.0,,5396.43,Services/Home Improvement,Nottingham,UK
2674,24/03/2020,BP,SAVE THE CHANGE,0.76,,5421.43,Savings,Nottingham,UK
2675,23/03/2020,DEB,YANKEE STORE,12.24,,5422.19,Other Shopping,,
2676,23/03/2020,DD,HARLANDS,25.0,,5434.43,Fitness,Nottingham,UK
2677,23/03/2020,BP,SAVE THE CHANGE,1.38,,5459.43,Savings,Nottingham,UK
2678,23/03/2020,DEB,HOLLAND & BARRETT,24.68,,5460.81,Groceries,,
2679,23/03/2020,DEB,AMAZON.CO.UK*425LQ,7.75,,5485.49,Amazon,Nottingham,UK
2680,20/03/2020,DEB,AMAZON.CO.UK*GF4UX,13.99,,5493.24,Amazon,Nottingham,UK
2681,20/03/2020,DEB,TESCO STORES 6735,7.2,,5507.23,Groceries,,
2682,20/03/2020,CPT,LNK NOTTINGHAM UNI,40.0,,5514.43,Cash,Nottingham,UK
2683,20/03/2020,BP,SAVE THE CHANGE,0.5,,5554.43,Savings,Nottingham,UK
2684,19/03/2020,DEB,WWW.III.CO.UK DE,4000.0,,5554.93,Investment,Nottingham,UK
2685,19/03/2020,DEB,LIDL GB NOTTINGHAM,8.5,,9554.93,Groceries,Nottingham,UK
2686,19/03/2020,BP,SAVE THE CHANGE,0.39,,9563.43,Savings,Nottingham,UK
2687,19/03/2020,BGC,DWR CYMRU WELSH WA,,180.29,9563.82,Supplementary Income,Nottingham,UK
2688,18/03/2020,DEB,GHOUSIA FOODS,28.61,,9383.53,Groceries,Nottingham,UK
2689,18/03/2020,TFR,R LAWRENCE,,4350.57,9412.14,Supplementary Income,Nottingham,UK
2690,18/03/2020,BP,SAVE THE CHANGE,0.01,,5061.57,Savings,Nottingham,UK
2691,17/03/2020,DEB,AMZNMktplace,13.99,,5061.58,Amazon,Nottingham,UK
2692,17/03/2020,DEB,AMZ*Amazon.co.uk,,5.0,5075.57,Supplementary Income,Nottingham,UK
2693,16/03/2020,FPI,ANMF CREDIT,,959.1,5070.57,Supplementary Income,Nottingham,UK
2694,16/03/2020,DD,O2,14.72,,4111.47,Other Shopping,Nottingham,UK
2695,16/03/2020,BP,SAVE THE CHANGE,0.72,,4126.19,Savings,Nottingham,UK
2696,16/03/2020,DEB,IZ *BIRD & BLEND T,15.0,,4126.91,Dine Out,Nottingham,UK
2697,16/03/2020,DEB,LIDL GB NOTTINGHAM,10.29,,4141.91,Groceries,Nottingham,UK
2698,16/03/2020,FPI,Q WANG   14MAR20,,300.0,4152.2,Supplementary Income,Nottingham,UK
2699,16/03/2020,CPT,LNK TESCO LONG ROW,40.0,,3852.2,Cash,Nottingham,UK
2700,13/03/2020,DEB,WWW.III.CO.UK DE,5000.0,,3892.2,Investment,Nottingham,UK
2701,13/03/2020,DEB,HARLANDS GROUP,110.0,,8892.2,Fitness,Nottingham,UK
2702,13/03/2020,DEB,AMZNMktplace,31.99,,9002.2,Amazon,Nottingham,UK
2703,2020-12-03 00:00:00,CPT,LNK NOTTINGHAM UNI,40.0,,9034.19,Cash,Nottingham,UK
2704,2020-12-03 00:00:00,FPO,ALICJA ALEXANDER,25.0,,9074.19,Services/Home Improvement,Nottingham,UK
2705,2020-12-03 00:00:00,BP,SAVE THE CHANGE,0.01,,9099.19,Savings,Nottingham,UK
2706,2020-11-03 00:00:00,DEB,AMZNMktplace,12.99,,9099.2,Amazon,Nottingham,UK
2707,2020-11-03 00:00:00,BGC,GOOD ENERGY LTD,,290.18,9112.19,Supplementary Income,Nottingham,UK
2708,2020-10-03 00:00:00,FPO,TRISTRAMS LETTINGS,825.0,,8822.01,Home Improvement,Nottingham,UK
2709,2020-09-03 00:00:00,DEB,Amazon Prime*2S40E,79.0,,9647.01,Amazon,Nottingham,UK
2710,2020-09-03 00:00:00,CPT,LNK H&T NOTTINGHAM,50.0,,9726.01,Cash,Nottingham,UK
2711,2020-06-03 00:00:00,CPT,LNK NOTTINGHAM UNI,50.0,,9776.01,Cash,Nottingham,UK
2712,2020-06-03 00:00:00,FPO,SALLY GOLDSTONE,231.0,,9826.01,Others,Nottingham,UK
2713,2020-06-03 00:00:00,TFR,R LAWRENCE,84000.0,,10057.01,Account transfer,Nottingham,UK
2714,2020-06-03 00:00:00,BP,SAVE THE CHANGE,0.17,,94057.01,Savings,Nottingham,UK
2715,2020-05-03 00:00:00,DEB,CO-OP GROUP 010661,8.83,,94057.18,Groceries,,
2716,2020-03-03 00:00:00,DEP,CLUB LLOYDS WAIVED,,3.0,94066.01,Supplementary Income,Nottingham,UK
2717,2020-03-03 00:00:00,PAY,CLUB LLOYDS FEE,3.0,,94063.01,Bills,Nottingham,UK
2718,2020-03-03 00:00:00,TFR,F/FLOW HOWELLS LEG,,83840.54,94066.01,Supplementary Income,Nottingham,UK
2719,2020-03-03 00:00:00,CPT,LNK NOTTINGHAM UNI,40.0,,10225.47,Cash,Nottingham,UK
2720,2020-03-03 00:00:00,BP,SAVE THE CHANGE,0.48,,10265.47,Savings,Nottingham,UK
2721,2020-02-03 00:00:00,,INTEREST (GROSS),,4.56,10265.95,Interest,Nottingham,UK
2722,2020-02-03 00:00:00,DEB,WWW.III.CO.UK DE,5000.0,,10261.39,Investment,Nottingham,UK
2723,2020-02-03 00:00:00,DEB,EB *REGGEATON WORK,13.52,,15261.39,Entertainment,London,UK
2724,2020-02-03 00:00:00,DD,SANTANDER MORTGAGE,959.1,,15274.91,Mortgage,Nottingham,UK
2725,2020-02-03 00:00:00,DD,DWR CYMRU W WATER,32.5,,16234.01,Bills,Nottingham,UK
2726,2020-02-03 00:00:00,SO,ESAVINGS ACCOUNT,300.0,,16266.51,Savings,Nottingham,UK
2727,2020-02-03 00:00:00,BP,SAVE THE CHANGE,0.37,,16566.51,Savings,Nottingham,UK
2728,2020-02-03 00:00:00,DEB,WWW.III.CO.UK DE,5000.0,,16566.88,Investment,Nottingham,UK
2729,2020-02-03 00:00:00,DEB,LIDL GB NOTTINGHAM,8.74,,21566.88,Groceries,Nottingham,UK
2730,2020-02-03 00:00:00,TFR,R LAWRENCE  01MAR20,,5000.0,21575.62,Supplementary Income,Nottingham,UK
2731,2020-02-03 00:00:00,DEB,LIDL GB NOTTINGHAM,7.89,,16575.62,Groceries,Nottingham,UK
2732,2020-02-03 00:00:00,CPT,LNK SAINSBURYS BAN,40.0,,16583.51,Cash,,
2733,2020-02-03 00:00:00,TFR,R LAWRENCE  29FEB20,,5000.0,16623.51,Supplementary Income,Nottingham,UK
2734,28/02/2020,DD,UCU B ACCOUNT,24.76,,11623.51,Others,Nottingham,UK
2735,28/02/2020,DD,TALKTALK LIMITED,19.3,,11648.27,Bills,Nottingham,UK
2736,28/02/2020,BP,SAVE THE CHANGE,0.52,,11667.57,Savings,Nottingham,UK
2737,27/02/2020,DEB,AMZNMktplace,18.99,,11668.09,Amazon,Nottingham,UK
2738,27/02/2020,DEB,AMZNMKTPLACE AMAZO,6.49,,11687.08,Amazon,Nottingham,UK
2739,27/02/2020,BGC,UNIV OF NOTTINGHAM,,3436.27,11693.57,Paycheck,Nottingham,UK
2740,26/02/2020,DEB,WWW.FATSOMA.COM,8.0,,8257.3,Entertainment,Nottingham,UK
2741,26/02/2020,CPT,LNK NOTTINGHAM UNI,40.0,,8265.3,Cash,Nottingham,UK
2742,26/02/2020,BP,SAVE THE CHANGE,0.36,,8305.3,Savings,Nottingham,UK
2743,25/02/2020,DEB,AMZNMktplace,26.64,,8305.66,Amazon,Nottingham,UK
2744,25/02/2020,BP,SAVE THE CHANGE,0.01,,8332.3,Savings,Nottingham,UK
2745,24/02/2020,DEB,Audible UK,7.99,,8332.31,Entertainment,Nottingham,UK
2746,24/02/2020,BP,SAVE THE CHANGE,0.42,,8340.3,Savings,Nottingham,UK
2747,24/02/2020,DEB,TIMPSON LTD,20.0,,8340.72,Other Shopping,,
2748,24/02/2020,DEB,LIDL GB NOTTINGHAM,7.58,,8360.72,Groceries,Nottingham,UK
2749,24/02/2020,DEB,WWW.SU.NOTTINGHAM.,44.0,,8368.3,Entertainment,Nottingham,UK
2750,21/02/2020,DEB,WWW.III.CO.UK DE,1100.0,,8412.3,Investment,Nottingham,UK
2751,21/02/2020,CPT,LNK UNIVERSITY PAR,40.0,,9512.3,Cash,Nottingham,UK
2752,21/02/2020,BP,SAVE THE CHANGE,0.69,,9552.3,Savings,Nottingham,UK
2753,20/02/2020,DEB,CO-OP GROUP 010661,13.31,,9552.99,Groceries,,
2754,20/02/2020,BP,SAVE THE CHANGE,0.04,,9566.3,Savings,Nottingham,UK
2755,19/02/2020,DEB,AMZNMktplace,43.96,,9566.34,Amazon,Nottingham,UK
2756,19/02/2020,BP,SAVE THE CHANGE,0.12,,9610.3,Savings,Nottingham,UK
2757,18/02/2020,DEB,LIDL GB NOTTINGHAM,9.88,,9610.42,Groceries,Nottingham,UK
2758,18/02/2020,FPO,TRISTRAMS,22.5,,9620.3,Home Improvement,Nottingham,UK
2759,17/02/2020,CPT,LNK NOTTINGHAM UNI,40.0,,9642.8,Cash,Nottingham,UK
2760,17/02/2020,DD,O2,18.94,,9682.8,Other Shopping,Nottingham,UK
2761,17/02/2020,BP,SAVE THE CHANGE,1.25,,9701.74,Savings,Nottingham,UK
2762,17/02/2020,BGC,C C SWANSEA,,224.71,9702.99,Supplementary Income,Nottingham,UK
2763,17/02/2020,DEB,ATRIUM JUBILEE 1,3.4,,9478.28,Dine Out,Nottingham,UK
2764,17/02/2020,DEB,Audible UK,18.0,,9481.68,Entertainment,Nottingham,UK
2765,17/02/2020,DEB,LIDL GB NOTTINGHAM,12.35,,9499.68,Groceries,Nottingham,UK
2766,14/02/2020,CPT,LNK NOTTINGHAM UNI,40.0,,9512.03,Cash,Nottingham,UK
2767,14/02/2020,BP,SAVE THE CHANGE,0.83,,9552.03,Savings,Nottingham,UK
2768,13/02/2020,DEB,CO-OP GROUP 010661,11.17,,9552.86,Groceries,,
2769,2020-11-02 00:00:00,BP,SAVE THE CHANGE,0.45,,9564.03,Savings,Nottingham,UK
2770,2020-10-02 00:00:00,DEB,TIMPSON LTD,15.0,,9564.48,Other Shopping,,
2771,2020-10-02 00:00:00,DEB,GHOUSIA FOODS,36.55,,9579.48,Groceries,Nottingham,UK
2772,2020-10-02 00:00:00,CPT,LNK NOTTINGHAM UNI,40.0,,9616.03,Cash,Nottingham,UK
2773,2020-10-02 00:00:00,BP,SAVE THE CHANGE,0.7,,9656.03,Savings,Nottingham,UK
2774,2020-10-02 00:00:00,DEB,CO-OP GROUP 010661,8.3,,9656.73,Groceries,,
2775,2020-06-02 00:00:00,BP,SAVE THE CHANGE,0.01,,9665.03,Savings,Nottingham,UK
2776,2020-05-02 00:00:00,DEB,POST OFFICE COUNTE,46.99,,9665.04,Others,Nottingham,UK
2777,2020-05-02 00:00:00,FPO,BORIS REMOVALS,1100.0,,9712.03,Others,Nottingham,UK
2778,2020-05-02 00:00:00,BP,SAVE THE CHANGE,0.6,,10812.03,Savings,Nottingham,UK
2779,2020-04-02 00:00:00,DEP,CLUB LLOYDS WAIVED,,3.0,10812.63,Supplementary Income,Nottingham,UK
2780,2020-04-02 00:00:00,PAY,CLUB LLOYDS FEE,3.0,,10809.63,Bills,Nottingham,UK
2781,2020-04-02 00:00:00,DEB,SAINSBURYS S/MKTS,30.4,,10812.63,Groceries,,
2782,2020-04-02 00:00:00,BP,SAVE THE CHANGE,0.75,,10843.03,Savings,Nottingham,UK
2783,2020-03-02 00:00:00,,INTEREST (GROSS),,5.21,10843.78,Interest,Nottingham,UK
2784,2020-03-02 00:00:00,DEB,ZINCO LOUNGE,16.25,,10838.57,Dine Out,Swansea,UK
2785,2020-03-02 00:00:00,DEB,SQ *TIKI BAR,5.0,,10854.82,Dine Out,Nottingham,UK
2786,2020-03-02 00:00:00,CPT,LNK PO THE CITYOFS,50.0,,10859.82,Cash,,
2787,2020-03-02 00:00:00,DD,SANTANDER MORTGAGE,959.09,,10909.82,Mortgage,Nottingham,UK
2788,2020-03-02 00:00:00,DD,GOOD ENERGY LTD,50.0,,11868.91,Bills,Nottingham,UK
2789,2020-03-02 00:00:00,DD,DWR CYMRU W WATER,32.5,,11918.91,Bills,Nottingham,UK
2790,2020-03-02 00:00:00,SO,ESAVINGS ACCOUNT,300.0,,11951.41,Savings,Nottingham,UK
2791,2020-03-02 00:00:00,BP,SAVE THE CHANGE,0.4,,12251.41,Savings,Nottingham,UK
2792,2020-03-02 00:00:00,DEB,WILKO RETAIL LIMIT,18.0,,12251.81,Other Shopping,,
2793,2020-03-02 00:00:00,DEB,Brontosaurus Vegan,16.62,,12269.81,Dine Out,Swansea,UK
2794,2020-03-02 00:00:00,DEB,CORGI HOMEPLAN,24.98,,12286.43,Home Improvement,Nottingham,UK
2795,31/01/2020,CPT,LNK M&S SWANSEA,50.0,,12311.41,Cash,Swansea,UK
2796,31/01/2020,FPO,TRISTRAMS,1585.0,,12361.41,Home Improvement,Nottingham,UK
2797,31/01/2020,DD,UCU B ACCOUNT,24.76,,13946.41,Others,Nottingham,UK
2798,31/01/2020,BGC,SWANSEA UNI - PAY,,3288.72,13971.17,Paycheck,Swansea,UK
2799,30/01/2020,BGC,UNIV OF NOTTINGHAM,,3412.29,10682.45,Paycheck,Nottingham,UK
2800,29/01/2020,BP,SAVE THE CHANGE,0.11,,7270.16,Savings,Nottingham,UK
2801,28/01/2020,DEB,AMZNMktplace,65.89,,7270.27,Amazon,Nottingham,UK
2802,28/01/2020,DD,TALKTALK LIMITED,19.95,,7336.16,Bills,Swansea,UK
2803,27/01/2020,FPO,BORIS REMOVALS,600.0,,7356.11,Others,Nottingham,UK
2804,27/01/2020,BP,SAVE THE CHANGE,0.35,,7956.11,Savings,Nottingham,UK
2805,27/01/2020,DEB,GRAPE TREE,27.66,,7956.46,Groceries,Leicester,UK
2806,27/01/2020,DEP,LOYD 802 OXFORD ST,,35.6,7984.12,Supplementary Income,Nottingham,UK
2807,27/01/2020,CPT,LOYD LOYD 802 OXFO,40.0,,7948.52,Cash,Swansea,UK
2808,24/01/2020,DEB,Audible UK,7.99,,7988.52,Entertainment,Nottingham,UK
2809,24/01/2020,CPT,LNK TESCO FABIAN W,40.0,,7996.51,Cash,Swansea,UK
2810,24/01/2020,BP,SAVE THE CHANGE,0.48,,8036.51,Savings,Nottingham,UK
2811,24/01/2020,BGC,CARDIFF MET EX A/C,,22.2,8036.99,Supplementary Income,Nottingham,UK
2812,23/01/2020,DEB,TESCO STORES 4628,5.52,,8014.79,Groceries,,
2813,22/01/2020,DD,CORGI HOMEPLAN,18.0,,8020.31,Home Improvement,Nottingham,UK
2814,21/01/2020,BP,SAVE THE CHANGE,0.2,,8038.31,Savings,Nottingham,UK
2815,20/01/2020,DEB,MOWGLI STREET FOOD,35.8,,8038.51,Dine Out,Nottingham,UK
2816,20/01/2020,FPO,TRISTRAMS LETTINGS,190.0,,8074.31,Home Improvement,Nottingham,UK
2817,20/01/2020,BP,SAVE THE CHANGE,0.02,,8264.31,Savings,Nottingham,UK
2818,20/01/2020,CPT,LNK 49-51 CLUMBER,40.0,,8264.33,Cash,Nottingham,UK
2819,20/01/2020,DEB,BUNNEYS BIKES LIMI,21.98,,8304.33,Other Shopping,Nottingham,UK
2820,17/01/2020,BP,SAVE THE CHANGE,0.9,,8326.31,Savings,Nottingham,UK
2821,16/01/2020,DEB,TFW RAIL SERVICES,98.2,,8327.21,Travel,,
2822,16/01/2020,DEB,TESCO STORES 5660,34.9,,8425.41,Groceries,,
2823,16/01/2020,DD,O2,18.55,,8460.31,Other Shopping,Nottingham,UK
2824,15/01/2020,CPT,LNK ARRIVA TRAINS,40.0,,8478.86,Cash,,
2825,15/01/2020,BP,SAVE THE CHANGE,0.01,,8518.86,Savings,Nottingham,UK
2826,14/01/2020,DEB,AMZNMktplace,9.99,,8518.87,Amazon,Nottingham,UK
2827,14/01/2020,BP,SAVE THE CHANGE,0.24,,8528.86,Savings,Nottingham,UK
2828,13/01/2020,DEB,WM MORRISONS STORE,15.8,,8529.1,Groceries,,
2829,13/01/2020,DEB,T K MAXX,13.96,,8544.9,Other Shopping,,
2830,13/01/2020,CPT,LNK SAINSBURYS BAN,80.0,,8558.86,Cash,,
2831,13/01/2020,CPT,LNK PO THE CITYOFS,50.0,,8638.86,Cash,,
2832,2020-10-01 00:00:00,DEB,Audible UK,18.0,,8688.86,Entertainment,Swansea,UK
2833,2020-10-01 00:00:00,CPT,LNK TESCO FABIAN W,40.0,,8706.86,Cash,Swansea,UK
2834,2020-10-01 00:00:00,BP,SAVE THE CHANGE,0.95,,8746.86,Savings,Nottingham,UK
2835,2020-09-01 00:00:00,DEB,Amazon.co.uk*4L6WG,63.1,,8747.81,Amazon,Nottingham,UK
2836,2020-09-01 00:00:00,DEB,AMZNMktplace,19.99,,8810.91,Amazon,Nottingham,UK
2837,2020-09-01 00:00:00,DEB,Amazon.co.uk*AJ1IW,18.96,,8830.9,Amazon,Nottingham,UK
2838,2020-09-01 00:00:00,BP,SAVE THE CHANGE,0.03,,8849.86,Savings,Nottingham,UK
2839,2020-08-01 00:00:00,DEB,HOWELLS SOLICITORS,180.0,,8849.89,Bills,Swansea,UK
2840,2020-08-01 00:00:00,DEB,AMZNMktplace,3.97,,9029.89,Amazon,Nottingham,UK
2841,2020-08-01 00:00:00,CPT,LOYD LOYD 802 OXFO,40.0,,9033.86,Cash,Swansea,UK
2842,2020-08-01 00:00:00,BP,SAVE THE CHANGE,0.13,,9073.86,Savings,Nottingham,UK
2843,2020-07-01 00:00:00,DEB,AIRBNB * HM9YBKEXN,469.87,,9073.99,Hotels,,
2844,2020-07-01 00:00:00,DD,THE GYM LTD,14.99,,9543.86,Fitness,Swansea,UK
2845,2020-06-01 00:00:00,BP,SAVE THE CHANGE,0.46,,9558.85,Savings,Nottingham,UK
2846,2020-06-01 00:00:00,CPT,LNK M&S SWANSEA,50.0,,9559.31,Cash,Swansea,UK
2847,2020-03-01 00:00:00,DEP,CLUB LLOYDS WAIVED,,3.0,9609.31,Supplementary Income,Nottingham,UK
2848,2020-03-01 00:00:00,PAY,CLUB LLOYDS FEE,3.0,,9606.31,Bills,Swansea,UK
2849,2020-03-01 00:00:00,DEB,NON-GBP PURCH FEE,0.5,,9609.31,Others,Nottingham,UK
2850,2020-03-01 00:00:00,DEB,NON-GBP TRANS FEE,2.22,,9609.81,Others,Nottingham,UK
2851,2020-03-01 00:00:00,DEB,ATHLEAN-X,74.54,,9612.03,Entertainment,Swansea,UK
2852,2020-03-01 00:00:00,DD,ZURICH,24.82,,9686.57,Insurance,Swansea,UK
2853,2020-02-01 00:00:00,,INTEREST (GROSS),,5.05,9711.39,Interest,swansea,UK
2854,2020-02-01 00:00:00,DD,SANTANDER MORTGAGE,959.09,,9706.34,Mortgage,Swansea,UK
2855,2020-02-01 00:00:00,DD,CC SWANSEA C.TAX,147.0,,10665.43,Bills,Swansea,UK
2856,2020-02-01 00:00:00,DD,GOOD ENERGY LTD,50.0,,10812.43,Bills,Swansea,UK
2857,2020-02-01 00:00:00,DD,DWR CYMRU W WATER,32.5,,10862.43,Bills,Swansea,UK
2858,2020-02-01 00:00:00,SO,ESAVINGS ACCOUNT,300.0,,10894.93,Savings,Nottingham,UK
2859,2020-02-01 00:00:00,BP,SAVE THE CHANGE,0.5,,11194.93,Savings,Nottingham,UK
2860,2020-02-01 00:00:00,DEB,NOSDA STUDIO HOSTE,24.9,,11195.43,Hotels,Cardiff,UK
2861,31/12/2019,DEB,Electrolux plc,130.0,,11220.33,Home Improvement,swansea,UK
2862,31/12/2019,DEB,WILKO RETAIL LIMIT,3.6,,11350.33,Other Shopping,,
2863,31/12/2019,DEB,GREGGS PLC,2.0,,11353.93,Dine Out,,
2864,31/12/2019,DD,UCU B ACCOUNT,24.76,,11355.93,Others,Swansea,UK
2865,31/12/2019,DD,TALKTALK LIMITED,19.95,,11380.69,Bills,Swansea,UK
2866,31/12/2019,BGC,SWANSEA UNI - PAY,,3289.12,11400.64,Paycheck,Swansea,UK
2867,30/12/2019,CPT,LNK SWANSEA CITY C,50.0,,8111.52,Cash,Swansea,UK
2868,30/12/2019,CPT,LNK M&S SWANSEA,40.0,,8161.52,Cash,Swansea,UK
2869,27/12/2019,BP,SAVE THE CHANGE,0.01,,8201.52,Savings,Swansea,UK
2870,27/12/2019,BGC,GOOGLE IRELAND,,63.7,8201.53,Supplementary Income,Swansea,UK
2871,24/12/2019,DEB,SAINSBURYS S/MKTS,13.0,,8137.83,Groceries,,
2872,24/12/2019,DEB,Audible UK,7.99,,8150.83,Entertainment,Swansea,UK
2873,24/12/2019,BP,SAVE THE CHANGE,2.47,,8158.82,Savings,Swansea,UK
2874,23/12/2019,DEB,Brontosaurus Vegan,27.14,,8161.29,Dine Out,Swansea,UK
2875,23/12/2019,DEB,Amazon.co.uk*834HJ,15.54,,8188.43,Amazon,Swansea,UK
2876,23/12/2019,DEB,TURKISH LTD 311058,13.35,,8203.97,Travel,,
2877,23/12/2019,DEB,MARKS&SPENCER PLC,4.5,,8217.32,Clothes,,
2878,23/12/2019,DD,HARLANDS,25.0,,8221.82,Fitness,Swansea,UK
2879,23/12/2019,DD,CORGI HOMEPLAN,18.0,,8246.82,Home Improvement,swansea,UK
2880,23/12/2019,BP,SAVE THE CHANGE,0.91,,8264.82,Savings,Swansea,UK
2881,23/12/2019,DEB,AMZNMktplace,3.45,,8265.73,Amazon,Swansea,UK
2882,23/12/2019,CPT,LNK M&S SWANSEA,50.0,,8269.18,Cash,Swansea,UK
2883,23/12/2019,DEB,GODADDY.COM EUROPE,38.64,,8319.18,Others,Swansea,UK
2884,23/12/2019,DEB,IZ *Yogaya CIC,53.0,,8357.82,Fitness,,
2885,23/12/2019,FPO,AMELIA TERESZKIEWI,35.0,,8410.82,Services,Swansea,UK
2886,19/12/2019,BP,SAVE THE CHANGE,0.8,,8445.82,Savings,Swansea,UK
2887,18/12/2019,DEB,TFW RAIL SERVICES,12.2,,8446.62,Travel,,
2888,17/12/2019,CPT,LNK QUEEN STREET,20.0,,8458.82,Cash,Belfast,UK
2889,16/12/2019,DD,O2,18.39,,8478.82,Other Shopping,Swansea,UK
2890,16/12/2019,BP,SAVE THE CHANGE,1.81,,8497.21,Savings,Swansea,UK
2891,16/12/2019,DEB,Brontosaurus Vegan,15.65,,8499.02,Dine Out,Swansea,UK
2892,16/12/2019,DEB,MARKS&SPENCER PLC,4.7,,8514.67,Clothes,,
2893,16/12/2019,FPO,CRYSTAL CLEAR,20.0,,8519.37,Other Shopping,Bristol,
2894,13/12/2019,DEB,AMZNMKTPLACE AMAZO,2.81,,8539.37,Amazon,Swansea,UK
2895,13/12/2019,DEB,AMAZON.CO.UK*CQ7LW,5.03,,8542.18,Amazon,Swansea,UK
2896,13/12/2019,CPT,LNK FULTON HOUSE,50.0,,8547.21,Cash,Swansea,UK
2897,13/12/2019,BGC,SWANSEA UNIVERSITY,,2628.14,8597.21,Supplementary Income,Swansea,UK
2898,2019-11-12 00:00:00,DEB,TESCO STORES 4628,3.0,,5969.07,Groceries,,
2899,2019-10-12 00:00:00,CPT,LNK TESCO FABIAN W,40.0,,5972.07,Cash,Swansea,UK
2900,2019-09-12 00:00:00,DD,THE GYM LTD,14.99,,6012.07,Fitness,Swansea,UK
2901,2019-09-12 00:00:00,BP,SAVE THE CHANGE,1.39,,6027.06,Savings,Swansea,UK
2902,2019-09-12 00:00:00,DEB,Brontosaurus Vegan,18.62,,6028.45,Dine Out,Swansea,UK
2903,2019-09-12 00:00:00,DEB,MARKS&SPENCER PLC,2.5,,6047.07,Clothes,,
2904,2019-09-12 00:00:00,DEB,VIRGIN MEDIA PYMTS,96.5,,6049.57,Bills,Swansea,UK
2905,2019-09-12 00:00:00,DEB,AMAZON.CO.UK*0P5YW,8.99,,6146.07,Amazon,Swansea,UK
2906,2019-09-12 00:00:00,CPT,LNK M&S SWANSEA,40.0,,6155.06,Cash,Swansea,UK
2907,2019-06-12 00:00:00,CPT,LNK TESCO FABIAN W,40.0,,6195.06,Cash,Swansea,UK
2908,2019-06-12 00:00:00,BP,SAVE THE CHANGE,0.24,,6235.06,Savings,Swansea,UK
2909,2019-06-12 00:00:00,BGC,SHAREDEALING HSDL,,2.49,6235.3,Supplementary Income,Swansea,UK
2910,2019-05-12 00:00:00,DEB,AMAZON.CO.UK*JX94J,9.76,,6232.81,Amazon,Swansea,UK
2911,2019-04-12 00:00:00,DEB,TESCO STORES 4628,2.0,,6242.57,Groceries,,
2912,2019-03-12 00:00:00,DEP,CLUB LLOYDS WAIVED,,3.0,6244.57,Supplementary Income,Swansea,UK
2913,2019-03-12 00:00:00,PAY,CLUB LLOYDS FEE,3.0,,6241.57,Bills,Swansea,UK
2914,2019-03-12 00:00:00,DD,ZURICH,24.82,,6244.57,Insurance,Swansea,UK
2915,2019-02-12 00:00:00,,INTEREST (GROSS),,4.5,6269.39,Interest,Swansea,UK
2916,2019-02-12 00:00:00,CPT,LNK FABIAN WAY,50.0,,6264.89,Cash,Swansea,UK
2917,2019-02-12 00:00:00,DD,SANTANDER MORTGAGE,959.09,,6314.89,Mortgage,Swansea,UK
2918,2019-02-12 00:00:00,DD,CC SWANSEA C.TAX,147.0,,7273.98,Bills,Swansea,UK
2919,2019-02-12 00:00:00,DD,GOOD ENERGY LTD,50.0,,7420.98,Bills,Swansea,UK
2920,2019-02-12 00:00:00,DD,DWR CYMRU W WATER,32.5,,7470.98,Bills,Swansea,UK
2921,2019-02-12 00:00:00,SO,ESAVINGS ACCOUNT,300.0,,7503.48,Savings,Swansea,UK
2922,2019-02-12 00:00:00,BP,SAVE THE CHANGE,1.81,,7803.48,Savings,Swansea,UK
2923,2019-02-12 00:00:00,DEB,WILKO RETAIL LIMIT,22.4,,7805.29,Other Shopping,,
2924,2019-02-12 00:00:00,DEB,MARKS&SPENCER PLC,7.2,,7827.69,Clothes,,
2925,2019-02-12 00:00:00,DEB,SAINSBURYS S/MKTS,40.9,,7834.89,Groceries,,
2926,2019-02-12 00:00:00,CPT,LNK M&S SWANSEA,50.0,,7875.79,Cash,Swansea,UK
2927,29/11/2019,DEB,AMZNMktplace,13.99,,7925.79,Amazon,Swansea,UK
2928,29/11/2019,DEB,COFFEE NO 1 SWANSE,6.7,,7939.78,Dine Out,Swansea,UK
2929,29/11/2019,DD,UCU B ACCOUNT,24.76,,7946.48,Others,Swansea,UK
2930,29/11/2019,BGC,SWANSEA UNI - PAY,,3289.12,7971.24,Paycheck,Swansea,UK
2931,29/11/2019,BGC,SWANSEA UNIVERSITY,,190.5,4682.12,Supplementary Income,Swansea,UK
2932,28/11/2019,FPO,AMELIA TERESZKIEWI,15.0,,4491.62,Services,Swansea,UK
2933,28/11/2019,CPT,LNK M&S SWANSEA,40.0,,4506.62,Cash,Swansea,UK
2934,28/11/2019,FPO,SALLY GOLDSTONE,28.0,,4546.62,Others,Swansea,UK
2935,27/11/2019,DEB,THE BIKE HUB,35.0,,4574.62,Other Shopping,,
2936,27/11/2019,DD,TALKTALK LIMITED,19.95,,4609.62,Bills,Swansea,UK
2937,27/11/2019,BGC,SHAREDEALING HSDL,,200.0,4629.57,Supplementary Income,Swansea,UK
2938,25/11/2019,DD,HARLANDS,25.0,,4429.57,Fitness,Swansea,UK
2939,25/11/2019,BP,SAVE THE CHANGE,0.63,,4454.57,Savings,Swansea,UK
2940,25/11/2019,DEB,Brontosaurus Vegan,24.39,,4455.2,Dine Out,Swansea,UK
2941,25/11/2019,DEB,THE BIKE HUB,20.0,,4479.59,Other Shopping,,
2942,25/11/2019,DEB,Brontosaurus Vegan,14.99,,4499.59,Dine Out,Swansea,UK
2943,25/11/2019,DEB,Audible UK,7.99,,4514.58,Entertainment,Swansea,UK
2944,25/11/2019,CPT,LOYD LOYD 802 OXFO,50.0,,4522.57,Cash,Swansea,UK
2945,22/11/2019,CPT,LNK TESCO FABIAN W,20.0,,4572.57,Cash,Swansea,UK
2946,22/11/2019,DD,CORGI HOMEPLAN,18.0,,4592.57,Home Improvement,swansea,UK
2947,22/11/2019,BGC,SWANSEA UNIVERSITY,,186.29,4610.57,Supplementary Income,Swansea,UK
2948,20/11/2019,CPT,LNK TESCO FABIAN W,40.0,,4424.28,Cash,Swansea,UK
2949,20/11/2019,BP,SAVE THE CHANGE,0.96,,4464.28,Savings,Swansea,UK
2950,19/11/2019,DEB,AMZNMktplace,3.04,,4465.24,Amazon,Swansea,UK
2951,18/11/2019,DD,O2,38.42,,4468.28,Other Shopping,Swansea,UK
2952,18/11/2019,BP,SAVE THE CHANGE,1.7,,4506.7,Savings,Swansea,UK
2953,18/11/2019,DEB,Brontosaurus Vegan,41.18,,4508.4,Dine Out,Swansea,UK
2954,18/11/2019,DEB,MARKS&SPENCER PLC,7.12,,4549.58,Clothes,,
2955,18/11/2019,CPT,LNK M&S SWANSEA,40.0,,4556.7,Cash,Swansea,UK
2956,15/11/2019,FPO,AMELIA TERESZKIEWI,20.0,,4596.7,Services,Swansea,UK
2957,15/11/2019,CPT,LNK FULTON HOUSE,40.0,,4616.7,Cash,Swansea,UK
2958,15/11/2019,BGC,UNII OF BHAM INST,,115.6,4656.7,Supplementary Income,Swansea,UK
2959,14/11/2019,FPO,REMUS,27.37,,4541.1,Clothes,,
2960,13/11/2019,CPT,LNK TESCO FABIAN W,50.0,,4568.47,Cash,Swansea,UK
2961,2019-12-11 00:00:00,BP,SAVE THE CHANGE,0.2,,4618.47,Savings,Swansea,UK
2962,2019-11-11 00:00:00,DEB,ANOKI LTD,50.8,,4618.67,Dine Out,Nottingham,UK
2963,2019-11-11 00:00:00,CPT,LNK 36 CLUMBER STR,40.0,,4669.47,Cash,Nottingham,UK
2964,2019-07-11 00:00:00,DD,THE GYM LTD,14.99,,4709.47,Fitness,Swansea,UK
2965,2019-07-11 00:00:00,BP,SAVE THE CHANGE,3.45,,4724.46,Savings,Swansea,UK
2966,2019-06-11 00:00:00,DEB,TFW RAIL SERVICES,138.25,,4727.91,Travel,,
2967,2019-06-11 00:00:00,DEB,TESCO STORES 6213,25.6,,4866.16,Groceries,,
2968,2019-06-11 00:00:00,DEB,UBER TRIP HELP.UBE,9.16,,4891.76,Travel,,
2969,2019-06-11 00:00:00,DEB,UBER TRIP HELP.UBE,8.04,,4900.92,Travel,,
2970,2019-06-11 00:00:00,DEB,UBER TRIP HELP.UBE,3.5,,4908.96,Travel,,
2971,2019-04-11 00:00:00,DEP,CLUB LLOYDS WAIVED,,3.0,4912.46,Supplementary Income,Swansea,UK
2972,2019-04-11 00:00:00,PAY,CLUB LLOYDS FEE,3.0,,4909.46,Bills,Swansea,UK
2973,2019-04-11 00:00:00,BP,SAVE THE CHANGE,1.62,,4912.46,Savings,Swansea,UK
2974,2019-04-11 00:00:00,DEB,Brontosaurus Vegan,27.22,,4914.08,Dine Out,Swansea,UK
2975,2019-04-11 00:00:00,DEB,IZ *EZY VEGAN LTD,9.5,,4941.3,Dine Out,Nottingham,UK
2976,2019-04-11 00:00:00,CPT,LNK M&S SWANSEA,50.0,,4950.8,Cash,Swansea,UK
2977,2019-04-11 00:00:00,DEP,LOYD 802 OXFORD ST,,45.75,5000.8,Supplementary Income,Swansea,UK
2978,2019-04-11 00:00:00,CPT,LNK M&S SWANSEA,50.0,,4955.05,Cash,Swansea,UK
2979,2019-01-11 00:00:00,,INTEREST (GROSS),,4.78,5005.05,Interest,Swansea,UK
2980,2019-01-11 00:00:00,DEB,NON-GBP PURCH FEE,0.5,,5000.27,Others,Swansea,UK
2981,2019-01-11 00:00:00,DEB,NON-GBP TRANS FEE,1.27,,5000.77,Others,Swansea,UK
2982,2019-01-11 00:00:00,DEB,DELTA AIR   Baggag,42.66,,5002.04,Travel,,
2983,2019-01-11 00:00:00,CPT,LNK TESCO FABIAN W,50.0,,5044.7,Cash,Swansea,UK
2984,2019-01-11 00:00:00,DD,SANTANDER MORTGAGE,959.09,,5094.7,Mortgage,Swansea,UK
2985,2019-01-11 00:00:00,DD,CC SWANSEA C.TAX,147.0,,6053.79,Bills,Swansea,UK
2986,2019-01-11 00:00:00,DD,GOOD ENERGY LTD,50.0,,6200.79,Bills,Swansea,UK
2987,2019-01-11 00:00:00,DD,DWR CYMRU W WATER,32.5,,6250.79,Bills,Swansea,UK
2988,2019-01-11 00:00:00,DD,ZURICH,24.82,,6283.29,Insurance,Swansea,UK
2989,2019-01-11 00:00:00,SO,ESAVINGS ACCOUNT,300.0,,6308.11,Savings,Swansea,UK
2990,31/10/2019,DD,UCU B ACCOUNT,24.76,,6608.11,Others,Swansea,UK
2991,31/10/2019,BP,SAVE THE CHANGE,0.81,,6632.87,Savings,Swansea,UK
2992,31/10/2019,BGC,SWANSEA UNI - PAY,,3289.12,6633.68,Paycheck,Swansea,UK
2993,30/10/2019,FPO,SALLY GOLDSTONE,550.0,,3344.56,Others,Swansea,UK
2994,30/10/2019,DEB,NON-GBP PURCH FEE,0.5,,3894.56,Others,Swansea,UK
2995,30/10/2019,DEB,NON-GBP TRANS FEE,33.1,,3895.06,Others,Swansea,UK
2996,30/10/2019,DEB,PINNACLE VANCOUVER,1107.19,,3928.16,Hotels,Vancouver,Canada
2997,28/10/2019,DD,TALKTALK LIMITED,20.61,,5035.35,Bills,Swansea,UK
2998,28/10/2019,DEB,FOREIGN CASH FEE,1.5,,5055.96,Travel,,
2999,28/10/2019,DEB,PROSPECT POINT BAR,68.98,,5057.46,Dine Out,Vancouver,Canada
3000,25/10/2019,BP,SAVE THE CHANGE,0.01,,5126.44,Savings,Swansea,UK
3001,25/10/2019,BGC,SWANSEA UNIVERSITY,,923.05,5126.45,Supplementary Income,Swansea,UK
3002,24/10/2019,DEB,Audible.co.uk,7.99,,4203.4,Entertainment,Swansea,UK
3003,23/10/2019,DD,HARLANDS,25.0,,4211.39,Fitness,Swansea,UK
3004,23/10/2019,BP,SAVE THE CHANGE,0.67,,4236.39,Savings,Swansea,UK
3005,22/10/2019,DEB,NON-GBP PURCH FEE,0.5,,4237.06,Others,Swansea,UK
3006,22/10/2019,DEB,NON-GBP TRANS FEE,2.96,,4237.56,Others,Swansea,UK
3007,22/10/2019,DEB,RONSONS #102,99.33,,4240.52,Home Improvement,swansea,UK
3008,22/10/2019,DD,CORGI HOMEPLAN,18.0,,4339.85,Home Improvement,swansea,UK
3009,22/10/2019,BP,SAVE THE CHANGE,2.09,,4357.85,Savings,Swansea,UK
3010,21/10/2019,DEB,NON-GBP CASH FEE,1.5,,4359.94,Others,Swansea,UK
3011,21/10/2019,DEB,NON-GBP TRANS FEE,5.31,,4361.44,Others,Swansea,UK
3012,21/10/2019,DEB,*VANCOUVER CBC & M,177.86,,4366.75,Travel,Vancouver,Canada
3013,21/10/2019,DEB,NON-GBP PURCH FEE,0.5,,4544.61,Others,Swansea,UK
3014,21/10/2019,DEB,NON-GBP TRANS FEE,4.68,,4545.11,Others,Swansea,UK
3015,21/10/2019,DEB,PINNACLE VANCOUVER,156.74,,4549.79,Hotels,Vancouver,Canada
3016,21/10/2019,DEB,NON-GBP PURCH FEE,0.5,,4706.53,Others,Swansea,UK
3017,21/10/2019,DEB,NON-GBP TRANS FEE,0.25,,4707.03,Others,Swansea,UK
3018,21/10/2019,DEB,BLAZE PIZZA,8.5,,4707.28,Dine Out,,
3019,21/10/2019,DEB,BREKA BAKERY & CAF,2.62,,4715.78,Dine Out,,
3020,21/10/2019,DEB,NON-GBP PURCH FEE,0.5,,4718.4,Others,Swansea,UK
3021,21/10/2019,DEB,NON-GBP TRANS FEE,1.04,,4718.9,Others,Swansea,UK
3022,21/10/2019,DEB,AMTRAK  292795,35.05,,4719.94,Travel,,
3023,21/10/2019,DEB,KLM UNITEDKI074823,43.0,,4754.99,Travel,,
3024,21/10/2019,TFR,F/FLOW KING ABDULL,,216.93,4797.99,Supplementary Income,Swansea,UK
3025,21/10/2019,DD,VIRGIN MEDIA PYMTS,44.5,,4581.06,Bills,Swansea,UK
3026,21/10/2019,BP,SAVE THE CHANGE,3.49,,4625.56,Savings,Swansea,UK
3027,21/10/2019,DEB,NON-GBP PURCH FEE,0.5,,4629.05,Others,Swansea,UK
3028,21/10/2019,DEB,NON-GBP TRANS FEE,0.81,,4629.55,Others,Swansea,UK
3029,21/10/2019,DEB,OLD NAVY 4218,27.21,,4630.36,Clothes,,
3030,21/10/2019,DEB,NON-GBP PURCH FEE,0.5,,4657.57,Others,Swansea,UK
3031,21/10/2019,DEB,NON-GBP TRANS FEE,0.55,,4658.07,Others,Swansea,UK
3032,21/10/2019,DEB,UBER   TRIP,18.52,,4658.62,Travel,,
3033,21/10/2019,DEB,NON-GBP PURCH FEE,0.5,,4677.14,Others,Swansea,UK
3034,21/10/2019,DEB,NON-GBP TRANS FEE,1.32,,4677.64,Others,Swansea,UK
3035,21/10/2019,DEB,DHERGANE FARAH,44.4,,4678.96,Services,Swansea,UK
3036,21/10/2019,DEB,TFW RAIL SERVICES,50.4,,4723.36,Travel,,
3037,21/10/2019,DEB,M&S SIMPLY FOOD SS,6.4,,4773.76,Groceries,Swansea,UK
3038,18/10/2019,DEB,AIRBNB * HMABB9424,705.58,,4780.16,Hotels,,
3039,18/10/2019,BP,SAVE THE CHANGE,0.02,,5485.74,Savings,Swansea,UK
3040,17/10/2019,DEB,Audible.co.uk,18.0,,5485.76,Entertainment,Swansea,UK
3041,17/10/2019,DEB,AMZNMktplace,11.99,,5503.76,Amazon,Swansea,UK
3042,17/10/2019,DEB,AMZNMKTPLACE AMAZO,11.99,,5515.75,Amazon,Swansea,UK
3043,17/10/2019,BP,SAVE THE CHANGE,0.23,,5527.74,Savings,Swansea,UK
3044,16/10/2019,DEB,TURKISH LTD 311058,12.77,,5527.97,Travel,,
3045,16/10/2019,CHQ,54,35.0,,5540.74,Cash,,
3046,16/10/2019,DD,O2,18.39,,5575.74,Other Shopping,Swansea,UK
3047,16/10/2019,BP,SAVE THE CHANGE,0.2,,5594.13,Savings,Swansea,UK
3048,15/10/2019,DEB,AMZNMktplace,6.8,,5594.33,Amazon,Swansea,UK
3049,15/10/2019,CPT,LNK TESCO FABIAN W,50.0,,5601.13,Cash,Swansea,UK
3050,14/10/2019,BP,SAVE THE CHANGE,1.15,,5651.13,Savings,Swansea,UK
3051,14/10/2019,DEB,Brontosaurus Vegan,14.35,,5652.28,Dine Out,Swansea,UK
3052,14/10/2019,DEB,MARKS&SPENCER PLC,4.7,,5666.63,Clothes,,
3053,14/10/2019,CPT,LNK M&S SWANSEA,50.0,,5671.33,Cash,Swansea,UK
3054,2019-11-10 00:00:00,DEB,TFW RAIL SERVICES,103.8,,5721.33,Travel,,
3055,2019-10-10 00:00:00,BP,SAVE THE CHANGE,0.11,,5825.13,Savings,Swansea,UK
3056,2019-09-10 00:00:00,DEB,Amazon.co.uk*MO5VX,7.89,,5825.24,Amazon,Swansea,UK
3057,2019-09-10 00:00:00,CPT,LNK TESCO FABIAN W,50.0,,5833.13,Cash,Swansea,UK
3058,2019-08-10 00:00:00,BP,SAVE THE CHANGE,0.08,,5883.13,Savings,Swansea,UK
3059,2019-07-10 00:00:00,DEB,AMZNMktplace,8.92,,5883.21,Amazon,Swansea,UK
3060,2019-07-10 00:00:00,DD,HARLANDS,25.0,,5892.13,Fitness,Swansea,UK
3061,2019-07-10 00:00:00,DD,THE GYM LTD,14.99,,5917.13,Fitness,Swansea,UK
3062,2019-07-10 00:00:00,BP,SAVE THE CHANGE,1.54,,5932.12,Savings,Swansea,UK
3063,2019-07-10 00:00:00,DEB,WILKO RETAIL LIMIT,21.25,,5933.66,Other Shopping,,
3064,2019-07-10 00:00:00,DEB,MARKS&SPENCER PLC,11.71,,5954.91,Clothes,,
3065,2019-07-10 00:00:00,DEB,SAINSBURYS S/MKTS,13.5,,5966.62,Groceries,,
3066,2019-07-10 00:00:00,FPO,AMELIA TERESZKIEWI,20.0,,5980.12,Services,Swansea,UK
3067,2019-04-10 00:00:00,DEB,TESCO STORES 4628,5.0,,6000.12,Groceries,,
3068,2019-04-10 00:00:00,CPT,LNK TESCO FABIAN W,40.0,,6005.12,Cash,Swansea,UK
3069,2019-03-10 00:00:00,DEB,THE BIKE HUB,30.0,,6045.12,Other Shopping,,
3070,2019-02-10 00:00:00,DEP,CLUB LLOYDS WAIVED,,3.0,6075.12,Supplementary Income,Swansea,UK
3071,2019-02-10 00:00:00,PAY,CLUB LLOYDS FEE,3.0,,6072.12,Bills,Swansea,UK
3072,2019-02-10 00:00:00,CPT,LNK SWANSEA CITY C,50.0,,6075.12,Cash,Swansea,UK
3073,2019-02-10 00:00:00,BP,SAVE THE CHANGE,0.2,,6125.12,Savings,Swansea,UK
3074,2019-01-10 00:00:00,,INTEREST (GROSS),,5.78,6125.32,Interest,Swansea,UK
3075,2019-01-10 00:00:00,DEB,PETER ALAN RESIDEN,178.8,,6119.54,Rent,Swansea,UK
3076,2019-01-10 00:00:00,DD,SANTANDER MORTGAGE,959.09,,6298.34,Mortgage,Swansea,UK
3077,2019-01-10 00:00:00,DD,CC SWANSEA C.TAX,147.0,,7257.43,Bills,Swansea,UK
3078,2019-01-10 00:00:00,DD,GOOD ENERGY LTD,50.0,,7404.43,Bills,Swansea,UK
3079,2019-01-10 00:00:00,DD,DWR CYMRU W WATER,32.5,,7454.43,Bills,Swansea,UK
3080,2019-01-10 00:00:00,DD,ZURICH,24.82,,7486.93,Insurance,Swansea,UK
3081,2019-01-10 00:00:00,SO,ESAVINGS ACCOUNT,300.0,,7511.75,Savings,Swansea,UK
3082,30/09/2019,DD,UCU B ACCOUNT,24.76,,7811.75,Others,Swansea,UK
3083,30/09/2019,BP,SAVE THE CHANGE,2.48,,7836.51,Savings,Swansea,UK
3084,30/09/2019,BGC,SWANSEA UNI - PAY,,3311.76,7838.99,Paycheck,Swansea,UK
3085,30/09/2019,DEB,Brontosaurus Vegan,21.77,,4527.23,Dine Out,Swansea,UK
3086,30/09/2019,DEB,MARKS&SPENCER PLC,7.1,,4549.0,Clothes,,
3087,30/09/2019,DEB,SAINSBURYS S/MKTS,22.5,,4556.1,Groceries,,
3088,30/09/2019,CPT,LNK M&S SWANSEA,50.0,,4578.6,Cash,Swansea,UK
3089,27/09/2019,DEB,TURKISH LTD 311058,13.15,,4628.6,Travel,,
3090,27/09/2019,CPT,LNK TESCO FABIAN W,30.0,,4641.75,Cash,Swansea,UK
3091,25/09/2019,CPT,LNK TESCO FABIAN W,50.0,,4671.75,Cash,Swansea,UK
3092,25/09/2019,BP,SAVE THE CHANGE,0.01,,4721.75,Savings,Swansea,UK
3093,24/09/2019,DEB,Audible.co.uk,7.99,,4721.76,Entertainment,Swansea,UK
3094,24/09/2019,BP,SAVE THE CHANGE,0.3,,4729.75,Savings,Swansea,UK
3095,23/09/2019,DEB,Audible.co.uk,18.0,,4730.05,Entertainment,Swansea,UK
3096,23/09/2019,DEB,MARKS&SPENCER PLC,4.7,,4748.05,Clothes,,
3097,23/09/2019,DEB,URBANZENINSTRUCTOR,7.0,,4752.75,Services,Swansea,UK
3098,23/09/2019,CHQ,53,500.0,,4759.75,Cash,,
3099,23/09/2019,DD,VIRGIN MEDIA PYMTS,36.8,,5259.75,Bills,Swansea,UK
3100,23/09/2019,DD,CORGI HOMEPLAN,14.75,,5296.55,Home Improvement,swansea,UK
3101,23/09/2019,BP,SAVE THE CHANGE,0.63,,5311.3,Savings,Swansea,UK
3102,23/09/2019,DEB,Brontosaurus Vegan,10.79,,5311.93,Dine Out,Swansea,UK
3103,23/09/2019,CPT,LNK PO THE CITYOFS,50.0,,5322.72,Cash,,
3104,20/09/2019,DEB,AMZNMktplace,30.58,,5372.72,Amazon,Swansea,UK
3105,20/09/2019,BP,SAVE THE CHANGE,0.25,,5403.3,Savings,Swansea,UK
3106,20/09/2019,BGC,UNIV OF NOTTINGHAM,,186.29,5403.55,Paycheck,Nottingham,UK
3107,19/09/2019,DEB,NON-GBP PURCH FEE,0.5,,5217.26,Others,Swansea,UK
3108,19/09/2019,DEB,NON-GBP TRANS FEE,1.36,,5217.76,Others,Swansea,UK
3109,19/09/2019,DEB,NAME-CHEAP.COM,45.75,,5219.12,Purchase of uk.eg.org,Swansea,UK
3110,19/09/2019,BP,SAVE THE CHANGE,0.05,,5264.87,Savings,Swansea,UK
3111,18/09/2019,DEB,WWW.FREEDOM-LEISUR,5.95,,5264.92,Entertainment,Worcester,UK
3112,17/09/2019,DEB,ODEON UPT,10.0,,5270.87,Entertainment,,
3113,17/09/2019,TFR,F/FLOW AARHUS UNIV,,250.31,5280.87,Supplementary Income,Swansea,UK
3114,16/09/2019,CPT,LNK TESCO FABIAN W,50.0,,5030.56,Cash,Swansea,UK
3115,16/09/2019,DD,O2,23.38,,5080.56,Other Shopping,Swansea,UK
3116,16/09/2019,BP,SAVE THE CHANGE,1.76,,5103.94,Savings,Swansea,UK
3117,16/09/2019,DEB,Brontosaurus Vegan,13.28,,5105.7,Dine Out,Swansea,UK
3118,16/09/2019,DEB,SPORTSDIRECT 141,41.99,,5118.98,Other Shopping,,
3119,16/09/2019,DEB,Brontosaurus Vegan,13.04,,5160.97,Dine Out,Swansea,UK
3120,13/09/2019,DEB,AMZNMktplace,9.99,,5174.01,Amazon,Swansea,UK
3121,13/09/2019,DEB,AMZNMKTPLACE AMAZO,9.99,,5184.0,Amazon,Swansea,UK
3122,13/09/2019,DEB,WWW.FREEDOM-LEISUR,5.95,,5193.99,Entertainment,Worcester,UK
3123,13/09/2019,CPT,LOYD LOYD 802 OXFO,80.0,,5199.94,Cash,Swansea,UK
3124,13/09/2019,BP,SAVE THE CHANGE,0.45,,5279.94,Savings,Swansea,UK
3125,2019-12-09 00:00:00,DEB,SAINSBURYS S/MKTS,28.55,,5280.39,Groceries,,
3126,2019-12-09 00:00:00,BP,SAVE THE CHANGE,0.1,,5308.94,Savings,Swansea,UK
3127,2019-11-09 00:00:00,DEB,WWW.FREEDOM-LEISUR,5.95,,5309.04,Entertainment,Worcester,UK
3128,2019-11-09 00:00:00,DEB,Amazon.co.uk*MA0PV,0.95,,5314.99,Amazon,Swansea,UK
3129,2019-11-09 00:00:00,BP,SAVE THE CHANGE,0.9,,5315.94,Savings,Swansea,UK
3130,2019-10-09 00:00:00,DEB,TESCO STORES 5957,6.1,,5316.84,Groceries,,
3131,2019-10-09 00:00:00,CPT,LNK TESCO FABIAN W,50.0,,5322.94,Cash,Swansea,UK
3132,2019-10-09 00:00:00,BP,SAVE THE CHANGE,1.34,,5372.94,Savings,Swansea,UK
3133,2019-09-09 00:00:00,DEB,ORCHARD HOTEL,89.0,,5374.28,Hotels,Nottingham,UK
3134,2019-09-09 00:00:00,DEB,TFW RAIL SERVICES,84.2,,5463.28,Travel,,
3135,2019-09-09 00:00:00,DEB,AMZNMktplace,9.97,,5547.48,Amazon,Swansea,UK
3136,2019-09-09 00:00:00,DEB,WH SMITH,6.49,,5557.45,Other Shopping,,
3137,2019-09-09 00:00:00,DEB,POUNDLAND LTD 1414,4.0,,5563.94,Groceries,,
3138,2019-09-09 00:00:00,DEB,Audible.co.uk,18.0,,5567.94,Entertainment,Swansea,UK
3139,2019-09-09 00:00:00,DD,THE GYM LTD,14.99,,5585.94,Fitness,Swansea,UK
3140,2019-09-09 00:00:00,BP,SAVE THE CHANGE,0.51,,5600.93,Savings,Swansea,UK
3141,2019-09-09 00:00:00,DEB,MARKS&SPENCER PLC,12.5,,5601.44,Clothes,,
3142,2019-09-09 00:00:00,DEB,MARKS&SPENCER PLC,11.0,,5613.94,Clothes,,
3143,2019-09-09 00:00:00,CPT,LNK M&S SWANSEA,50.0,,5624.94,Cash,Swansea,UK
3144,2019-06-09 00:00:00,DEB,AMZNMKTPLACE AMAZO,10.99,,5674.94,Amazon,Swansea,UK
3145,2019-06-09 00:00:00,CPT,LNK TESCO FABIAN W,50.0,,5685.93,Cash,Swansea,UK
3146,2019-05-09 00:00:00,BP,SAVE THE CHANGE,0.75,,5735.93,Savings,Swansea,UK
3147,2019-04-09 00:00:00,DEB,SAINSBURYS S/MKTS,13.55,,5736.68,Groceries,,
3148,2019-04-09 00:00:00,DEB,WWW.FREEDOM-LEISUR,5.95,,5750.23,Entertainment,Worcester,UK
3149,2019-04-09 00:00:00,DEB,AMZNMktplace,2.75,,5756.18,Amazon,Swansea,UK
3150,2019-04-09 00:00:00,CPT,LNK TESCO FABIAN W,50.0,,5758.93,Cash,Swansea,UK
3151,2019-04-09 00:00:00,BP,SAVE THE CHANGE,0.19,,5808.93,Savings,Swansea,UK
3152,2019-03-09 00:00:00,DEP,CLUB LLOYDS WAIVED,,3.0,5809.12,Supplementary Income,Swansea,UK
3153,2019-03-09 00:00:00,PAY,CLUB LLOYDS FEE,3.0,,5806.12,Bills,Swansea,UK
3154,2019-03-09 00:00:00,DEB,WWW.III.CO.UK DE,1000.0,,5809.12,Investment,Swansea,UK
3155,2019-03-09 00:00:00,DEB,AMZNMktplace,2.81,,6809.12,Amazon,Swansea,UK
3156,2019-03-09 00:00:00,BP,SAVE THE CHANGE,0.4,,6811.93,Savings,Swansea,UK
3157,2019-02-09 00:00:00,,INTEREST (GROSS),,6.53,6812.33,Interest,Swansea,UK
3158,2019-02-09 00:00:00,FPI,E JAKUBOWSKA,,15.0,6805.8,Supplementary Income,Swansea,UK
3159,2019-02-09 00:00:00,DEB,M&S SIMPLY FOOD SS,9.6,,6790.8,Groceries,Swansea,UK
3160,2019-02-09 00:00:00,DD,SANTANDER MORTGAGE,1018.45,,6800.4,Mortgage,Swansea,UK
3161,2019-02-09 00:00:00,DD,CC SWANSEA C.TAX,147.0,,7818.85,Bills,Swansea,UK
3162,2019-02-09 00:00:00,DD,GOOD ENERGY LTD,50.0,,7965.85,Bills,Swansea,UK
3163,2019-02-09 00:00:00,DD,DWR CYMRU W WATER,32.5,,8015.85,Bills,Swansea,UK
3164,2019-02-09 00:00:00,DD,ZURICH,20.69,,8048.35,Insurance,Swansea,UK
3165,2019-02-09 00:00:00,SO,ESAVINGS ACCOUNT,300.0,,8069.04,Savings,Swansea,UK
3166,30/08/2019,DD,UCU B ACCOUNT,24.26,,8369.04,Others,Swansea,UK
3167,30/08/2019,BGC,SWANSEA UNI - PAY,,3311.76,8393.3,Paycheck,Swansea,UK
3168,28/08/2019,DEB,FOREIGN CASH FEE,1.5,,5081.54,Travel,,
3169,28/08/2019,DEB,CALLE CATALUNA 4,207.55,,5083.04,Travel,Madrid,Spain
3170,28/08/2019,DEB,REVOLUT*7996*,10.0,,5290.59,Dine Out,,
3171,27/08/2019,BP,SAVE THE CHANGE,3.08,,5300.59,Savings,Swansea,UK
3172,27/08/2019,DEB,NON-GBP PURCH FEE,0.5,,5303.67,Others,Swansea,UK
3173,27/08/2019,DEB,NON-GBP TRANS FEE,8.51,,5304.17,Others,Swansea,UK
3174,27/08/2019,DEB,AMISTAT ISLAND HOS,284.75,,5312.68,Hotels,Illes Balears,Spain
3175,27/08/2019,DEB,WWW.III.CO.UK DE,500.0,,5597.43,Investment,Nottingham,UK
3176,27/08/2019,DEB,WWW.III.CO.UK DE,500.0,,6097.43,Investment,Nottingham,UK
3177,27/08/2019,DEB,TFW RAIL SERVICES,50.4,,6597.43,Travel,,
3178,27/08/2019,DEB,BRS WDF MAIN,20.83,,6647.83,Other Shopping,Bristol,
3179,27/08/2019,DEB,M&S SIMPLY FOOD SS,8.0,,6668.66,Groceries,Swansea,UK
3180,27/08/2019,DEB,STARBUCKS COFFEE C,4.05,,6676.66,Dine Out,,
3181,27/08/2019,DEB,Audible.co.uk,7.99,,6680.71,Entertainment,Swansea,UK
3182,27/08/2019,DEB,SWANSEA UNI - CATE,4.65,,6688.7,Dine Out,Swansea,UK
3183,27/08/2019,TFR,R LAWRENCE  24AUG19,,500.0,6693.35,Supplementary Income,Swansea,UK
3184,23/08/2019,DEB,ZINCO LOUNGE,21.25,,6193.35,Dine Out,Swansea,UK
3185,23/08/2019,CPT,LNK FABIAN WAY,50.0,,6214.6,Cash,Swansea,UK
3186,22/08/2019,DD,CORGI HOMEPLAN,14.75,,6264.6,Home Improvement,swansea,UK
3187,22/08/2019,BP,SAVE THE CHANGE,0.05,,6279.35,Savings,Swansea,UK
3188,21/08/2019,DEB,WWW.FREEDOM-LEISUR,5.95,,6279.4,Entertainment,Worcester,UK
3189,21/08/2019,DEB,URBANZENINSTRUCTOR,7.0,,6285.35,Services,Swansea,UK
3190,21/08/2019,CPT,LNK M&S SWANSEA,60.0,,6292.35,Cash,Swansea,UK
3191,21/08/2019,DD,VIRGIN MEDIA PYMTS,29.0,,6352.35,Bills,Swansea,UK
3192,21/08/2019,BP,SAVE THE CHANGE,0.54,,6381.35,Savings,Swansea,UK
3193,20/08/2019,DEB,AMZNMktplace,19.97,,6381.89,Amazon,Swansea,UK
3194,20/08/2019,DEB,AMZNMKTPLACE AMAZO,12.99,,6401.86,Amazon,Swansea,UK
3195,20/08/2019,DEB,TESCO STORES 4628,6.5,,6414.85,Groceries,,
3196,20/08/2019,BP,SAVE THE CHANGE,1.11,,6421.35,Savings,Swansea,UK
3197,19/08/2019,DEB,WWW.III.CO.UK DE,900.0,,6422.46,Investment,Nottingham,UK
3198,19/08/2019,DEB,Audible.co.uk,4.41,,7322.46,Entertainment,Swansea,UK
3199,19/08/2019,DEB,SCANDIC AARHUS CIT,21.48,,7326.87,Travel,Aarhus,Denmark
3200,19/08/2019,BP,SAVE THE CHANGE,5.74,,7348.35,Savings,Swansea,UK
3201,19/08/2019,CPT,LNK 90146901 SA1 G,40.0,,7354.09,Cash,,
3202,19/08/2019,DEB,NON-GBP PURCH FEE,0.5,,7394.09,Others,Swansea,UK
3203,19/08/2019,DEB,NON-GBP TRANS FEE,1.63,,7394.59,Others,Swansea,UK
3204,19/08/2019,DEB,AMISTATISLANDHOSTE,54.72,,7396.22,Hotels,Illes Balears,Spain
3205,19/08/2019,DEB,NON-GBP PURCH FEE,0.5,,7450.94,Others,Swansea,UK
3206,19/08/2019,DEB,NON-GBP TRANS FEE,1.15,,7451.44,Others,Swansea,UK
3207,19/08/2019,DEB,MIB AARHUS LUFTHAV,38.72,,7452.59,Dine Out,Aarhus,Denmark
3208,19/08/2019,DEB,NON-GBP PURCH FEE,0.5,,7491.31,Others,Swansea,UK
3209,19/08/2019,DEB,NON-GBP TRANS FEE,0.42,,7491.81,Others,Swansea,UK
3210,19/08/2019,DEB,MIDTTRAFIK,14.18,,7492.23,Travel,,
3211,19/08/2019,DEB,NON-GBP PURCH FEE,0.5,,7506.41,Others,Swansea,UK
3212,19/08/2019,DEB,NON-GBP TRANS FEE,0.33,,7506.91,Others,Swansea,UK
3213,19/08/2019,DEB,MIB AARHUS LUFTHAV,11.1,,7507.24,Dine Out,Aarhus,Denmark
3214,19/08/2019,DEB,NON-GBP PURCH FEE,0.5,,7518.34,Others,Swansea,UK
3215,19/08/2019,DEB,NON-GBP TRANS FEE,0.53,,7518.84,Others,Swansea,UK
3216,19/08/2019,DEB,TAXAS KUNDECENTER,18.01,,7519.37,Services,Swansea,UK
3217,19/08/2019,DEB,NON-GBP PURCH FEE,0.5,,7537.38,Others,Swansea,UK
3218,19/08/2019,DEB,NON-GBP TRANS FEE,0.4,,7537.88,Others,Swansea,UK
3219,19/08/2019,DEB,SHAKSHUKA,13.57,,7538.28,Dine Out,,
3220,19/08/2019,DEB,NON-GBP PURCH FEE,0.5,,7551.85,Others,Swansea,UK
3221,19/08/2019,DEB,NON-GBP TRANS FEE,0.19,,7552.35,Others,Swansea,UK
3222,19/08/2019,DEB,DEEDEES ApS,6.41,,7552.54,Dine Out,Aarhus,Denmark
3223,16/08/2019,DEB,NON-GBP PURCH FEE,0.5,,7558.95,Others,Swansea,UK
3224,16/08/2019,DEB,NON-GBP TRANS FEE,0.42,,7559.45,Others,Swansea,UK
3225,16/08/2019,DEB,MIDTTRAFIK,14.26,,7559.87,Travel,,
3226,16/08/2019,DEB,RADISSON BLU HOTEL,114.3,,7574.13,Hotels,Leeds,UK
3227,16/08/2019,DEB,AMZNMKTPLACE AMAZO,5.99,,7688.43,Amazon,Swansea,UK
3228,16/08/2019,DD,O2,23.38,,7694.42,Other Shopping,Swansea,UK
3229,16/08/2019,BP,SAVE THE CHANGE,1.22,,7717.8,Savings,Swansea,UK
3230,16/08/2019,BGC,SWANSEA UNIVERSITY,,1695.55,7719.02,Supplementary Income,Swansea,UK
3231,15/08/2019,DEB,TFW RAIL SERVICES,97.1,,6023.47,Travel,,
3232,15/08/2019,DEB,Brontosaurus Vegan,12.99,,6120.57,Dine Out,Swansea,UK
3233,15/08/2019,DEB,RYANAIR   224000,28.69,,6133.56,Travel,,
3234,15/08/2019,BP,SAVE THE CHANGE,0.01,,6162.25,Savings,Swansea,UK
3235,14/08/2019,DEB,RYANAIR   224000,29.0,,6162.26,Travel,,
3236,14/08/2019,DEB,AMZNMktplace,16.99,,6191.26,Amazon,Swansea,UK
3237,14/08/2019,BP,SAVE THE CHANGE,0.11,,6208.25,Savings,Swansea,UK
3238,13/08/2019,DEB,WWW.III.CO.UK DE,1100.0,,6208.36,Investment,Nottingham,UK
3239,13/08/2019,DEB,SAINSBURYS S/MKTS,16.9,,7308.36,Groceries,,
3240,13/08/2019,DEB,AMZNMktplace,9.99,,7325.26,Amazon,Swansea,UK
3241,13/08/2019,CPT,LNK TESCO FABIAN W,60.0,,7335.25,Cash,Swansea,UK
3242,13/08/2019,BP,SAVE THE CHANGE,0.45,,7395.25,Savings,Swansea,UK
3243,2019-12-08 00:00:00,TFR,R LAWRENCE,,1100.0,7395.7,Supplementary Income,Swansea,UK
3244,2019-12-08 00:00:00,DEB,COFFEE#1 SWANSEA,8.55,,6295.7,Dine Out,Swansea,UK
3245,2019-12-08 00:00:00,BP,SAVE THE CHANGE,4.55,,6304.25,Savings,Swansea,UK
3246,2019-12-08 00:00:00,DEB,COFFEE#1 SWANSEA,11.85,,6308.8,Dine Out,Swansea,UK
3247,2019-12-08 00:00:00,DEB,VALLEY MILL LTD,10.95,,6320.65,Other Shopping,,
3248,2019-12-08 00:00:00,DEB,MARKS&SPENCER PLC,9.7,,6331.6,Clothes,,
3249,2019-12-08 00:00:00,DEB,WILKO RETAIL LIMIT,8.0,,6341.3,Other Shopping,,
3250,2019-12-08 00:00:00,DEB,WILKO RETAIL LIMIT,6.5,,6349.3,Other Shopping,,
3251,2019-12-08 00:00:00,FPO,AMELIA TERESZKIEWI,35.0,,6355.8,Services,Swansea,UK
3252,2019-12-08 00:00:00,DEB,NON-GBP PURCH FEE,0.5,,6390.8,Others,Swansea,UK
3253,2019-12-08 00:00:00,DEB,NON-GBP TRANS FEE,0.19,,6391.3,Others,Swansea,UK
3254,2019-12-08 00:00:00,DEB,HMSHOST AMSTERDAM,6.52,,6391.49,Dine Out,Amsterdam,Netherlands
3255,2019-12-08 00:00:00,DEB,ZINCO LOUNGE,12.45,,6398.01,Dine Out,Swansea,UK
3256,2019-12-08 00:00:00,DEB,AMZNMktplace,3.26,,6410.46,Amazon,Swansea,UK
3257,2019-12-08 00:00:00,DEB,AMZNMktplace,2.97,,6413.72,Amazon,Swansea,UK
3258,2019-12-08 00:00:00,DEB,AMZNMKTPLACE AMAZO,66.94,,6416.69,Amazon,Swansea,UK
3259,2019-12-08 00:00:00,CPT,LNK SWANSEA CITY C,50.0,,6483.63,Cash,Swansea,UK
3260,2019-12-08 00:00:00,DEB,NON-GBP PURCH FEE,0.5,,6533.63,Others,Swansea,UK
3261,2019-12-08 00:00:00,DEB,NON-GBP TRANS FEE,1.38,,6534.13,Others,Swansea,UK
3262,2019-12-08 00:00:00,DEB,DELTA AIR   Baggag,46.3,,6535.51,Travel,,
3263,2019-09-08 00:00:00,CPT,LNK TESCO FABIAN W,60.0,,6581.81,Cash,Swansea,UK
3264,2019-09-08 00:00:00,DEB,NON-GBP PURCH FEE,0.5,,6641.81,Others,Swansea,UK
3265,2019-09-08 00:00:00,DEB,NON-GBP TRANS FEE,1.4,,6642.31,Others,Swansea,UK
3266,2019-09-08 00:00:00,DEB,NEWSLINK 16 BOS,47.01,,6643.71,Other Shopping,Boston,USA
3267,2019-08-08 00:00:00,DEB,WWW.III.CO.UK DE,100.0,,6690.72,Investment,Swansea,UK
3268,2019-07-08 00:00:00,DD,THE GYM LTD,14.99,,6790.72,Fitness,Swansea,UK
3269,2019-07-08 00:00:00,BP,SAVE THE CHANGE,0.53,,6805.71,Savings,Swansea,UK
3270,2019-06-08 00:00:00,DEB,WWW.III.CO.UK DE,1000.0,,6806.24,Investment,Swansea,UK
3271,2019-06-08 00:00:00,DEB,NON-GBP PURCH FEE,0.5,,7806.24,Others,Swansea,UK
3272,2019-06-08 00:00:00,DEB,NON-GBP TRANS FEE,1.06,,7806.74,Others,Swansea,UK
3273,2019-06-08 00:00:00,DEB,WHOLEFDS BLH 10091,35.47,,7807.8,Groceries ,,
3274,2019-05-08 00:00:00,BP,SAVE THE CHANGE,0.44,,7843.27,Savings,Swansea,UK
3275,2019-05-08 00:00:00,DEB,NON-GBP PURCH FEE,0.5,,7843.71,Others,Swansea,UK
3276,2019-05-08 00:00:00,DEB,NON-GBP TRANS FEE,1.16,,7844.21,Others,Swansea,UK
3277,2019-05-08 00:00:00,DEB,SHAWS #0677,38.88,,7845.37,Services,Swansea,UK
3278,2019-02-08 00:00:00,DEP,CLUB LLOYDS WAIVED,,3.0,7884.25,Supplementary Income,Swansea,UK
3279,2019-02-08 00:00:00,PAY,CLUB LLOYDS FEE,3.0,,7881.25,Bills,Swansea,UK
3280,2019-02-08 00:00:00,DEB,NON-GBP PURCH FEE,0.5,,7884.25,Others,Swansea,UK
3281,2019-02-08 00:00:00,DEB,NON-GBP TRANS FEE,0.7,,7884.75,Others,Swansea,UK
3282,2019-02-08 00:00:00,DEB,SAVERS - 1207,23.68,,7885.45,Other Shopping,,
3283,2019-02-08 00:00:00,BP,SAVE THE CHANGE,0.04,,7909.13,Savings,Swansea,UK
3284,2019-01-08 00:00:00,,INTEREST (GROSS),,5.53,7909.17,Interest,Swansea,UK
3285,2019-01-08 00:00:00,DD,CC SWANSEA C.TAX,147.0,,7903.64,Bills,Swansea,UK
3286,2019-01-08 00:00:00,DD,GOOD ENERGY LTD,50.0,,8050.64,Bills,Swansea,UK
3287,2019-01-08 00:00:00,DD,DWR CYMRU W WATER,32.5,,8100.64,Bills,Swansea,UK
3288,2019-01-08 00:00:00,DD,ZURICH,20.69,,8133.14,Insurance,Swansea,UK
3289,2019-01-08 00:00:00,DEB,NON-GBP PURCH FEE,0.5,,8153.83,Others,Swansea,UK
3290,2019-01-08 00:00:00,DEB,NON-GBP TRANS FEE,0.98,,8154.33,Others,Swansea,UK
3291,2019-01-08 00:00:00,DEB,GAP US 822,32.96,,8155.31,Clothes,,
3292,2019-01-08 00:00:00,SO,ESAVINGS ACCOUNT,300.0,,8188.27,Savings,Swansea,UK
3293,2019-01-08 00:00:00,BP,SAVE THE CHANGE,0.75,,8488.27,Savings,Swansea,UK
3294,31/07/2019,DEB,DOUBLETREE BY HILT,101.25,,8489.02,Hotels,,
3295,31/07/2019,DD,UCU B ACCOUNT,24.26,,8590.27,Others,Swansea,UK
3296,31/07/2019,BP,SAVE THE CHANGE,0.6,,8614.53,Savings,Swansea,UK
3297,31/07/2019,BGC,SWANSEA UNI - PAY,,3265.85,8615.13,Paycheck,Swansea,UK
3298,30/07/2019,DEB,NON-GBP CASH FEE,1.5,,5349.28,Others,Swansea,UK
3299,30/07/2019,DEB,NON-GBP TRANS FEE,4.97,,5350.78,Others,Swansea,UK
3300,30/07/2019,DEB,*EASTERN AVENUE RE,166.24,,5355.75,Home Improvement,swansea,UK
3301,30/07/2019,DEB,TFW RAIL SERVICES,50.4,,5521.99,Travel,,
3302,30/07/2019,BP,SAVE THE CHANGE,0.99,,5572.39,Savings,Swansea,UK
3303,29/07/2019,DEB,Brontosaurus Vegan,15.52,,5573.38,Dine Out,Swansea,UK
3304,29/07/2019,DEB,AMZNMktplace,199.49,,5588.9,Amazon,Swansea,UK
3305,29/07/2019,DEB,URBANZENINSTRUCTOR,7.0,,5788.39,Services,Swansea,UK
3306,29/07/2019,CPT,LOYD LOYD 802 OXFO,50.0,,5795.39,Cash,Swansea,UK
3307,26/07/2019,BP,SAVE THE CHANGE,1.61,,5845.39,Savings,Swansea,UK
3308,26/07/2019,BGC,SWANSEA UNIVERSITY,,38.31,5847.0,Supplementary Income,Swansea,UK
3309,25/07/2019,DEB,NON-GBP PURCH FEE,0.5,,5808.69,Others,Swansea,UK
3310,25/07/2019,DEB,NON-GBP TRANS FEE,0.69,,5809.19,Others,Swansea,UK
3311,25/07/2019,DEB,ASKCRAIG,23.34,,5809.88,Entertainment,,
3312,25/07/2019,DEB,RYANAIR   224000,49.97,,5833.22,Travel,,
3313,25/07/2019,DEB,NON-GBP PURCH FEE,0.5,,5883.19,Others,Swansea,UK
3314,25/07/2019,DEB,NON-GBP TRANS FEE,0.83,,5883.69,Others,Swansea,UK
3315,25/07/2019,DEB,RYANAIR   000000,28.08,,5884.52,Travel,,
3316,25/07/2019,CPT,LNK TESCO FABIAN W,100.0,,5912.6,Cash,Swansea,UK
3317,25/07/2019,BP,SAVE THE CHANGE,0.01,,6012.6,Savings,Swansea,UK
3318,24/07/2019,DEB,Audible.co.uk,7.99,,6012.61,Entertainment,Swansea,UK
3319,23/07/2019,BP,SAVE THE CHANGE,0.57,,6020.6,Savings,Swansea,UK
3320,22/07/2019,DEB,T K MAXX,48.93,,6021.17,Other Shopping,,
3321,22/07/2019,DEB,AMZNMktplace,6.5,,6070.1,Amazon,Swansea,UK
3322,22/07/2019,DEB,URBANZENINSTRUCTOR,7.0,,6076.6,Services,Swansea,UK
3323,22/07/2019,TFR,F/FLOW GRINDEYS LL,,1069.68,6083.6,Supplementary Income,Swansea,UK
3324,22/07/2019,DD,VIRGIN MEDIA PYMTS,29.0,,5013.92,Bills,Swansea,UK
3325,22/07/2019,DD,CORGI HOMEPLAN,14.75,,5042.92,Home Improvement,swansea,UK
3326,19/07/2019,FPO,AMELIA TERESZKIEWI,20.0,,5057.67,Services,Swansea,UK
3327,19/07/2019,CPT,LNK TESCO FABIAN W,50.0,,5077.67,Cash,Swansea,UK
3328,19/07/2019,BGC,SWANSEA UNIVERSITY,,1868.98,5127.67,Supplementary Income,Swansea,UK
3329,18/07/2019,BP,SAVE THE CHANGE,0.7,,3258.69,Savings,Swansea,UK
3330,17/07/2019,DEB,SAINSBURYS S/MKTS,10.3,,3259.39,Groceries,,
3331,17/07/2019,BP,SAVE THE CHANGE,0.8,,3269.69,Savings,Swansea,UK
3332,16/07/2019,FPO,CARL DAVENPORT,60.0,,3270.49,Entertainment,Swansea,UK
3333,16/07/2019,DEB,AMAZON.CO.UK*MH023,36.2,,3330.49,Amazon,Swansea,UK
3334,16/07/2019,DD,O2,18.45,,3366.69,Other Shopping,Swansea,UK
3335,16/07/2019,BP,SAVE THE CHANGE,2.54,,3385.14,Savings,Swansea,UK
3336,15/07/2019,DEB,Brontosaurus Vegan,18.07,,3387.68,Dine Out,Swansea,UK
3337,15/07/2019,DEB,MARKS&SPENCER PLC,7.7,,3405.75,Clothes,,
3338,15/07/2019,DEB,Audible.co.uk,18.0,,3413.45,Entertainment,Swansea,UK
3339,15/07/2019,DEB,ZINCO LOUNGE,7.65,,3431.45,Dine Out,Swansea,UK
3340,15/07/2019,DEB,AMZNMktplace,3.04,,3439.1,Amazon,Swansea,UK
3341,15/07/2019,DEB,URBANZENINSTRUCTOR,7.0,,3442.14,Services,Swansea,UK
3342,15/07/2019,BP,SAVE THE CHANGE,0.97,,3449.14,Savings,Swansea,UK
3343,15/07/2019,CPT,LNK 1 UNION STREET,200.0,,3450.11,Cash,Leicester,UK
3344,2019-12-07 00:00:00,DEB,EASYJET   000EXG,298.48,,3650.11,Travel,,
3345,2019-12-07 00:00:00,DEB,HOSTEL WORLD,61.55,,3948.59,Hotels,,
3346,2019-11-07 00:00:00,BP,SAVE THE CHANGE,0.15,,4010.14,Savings,Swansea,UK
3347,2019-10-07 00:00:00,DEB,ZINCO LOUNGE,19.85,,4010.29,Dine Out,Swansea,UK
3348,2019-10-07 00:00:00,BP,SAVE THE CHANGE,0.08,,4030.14,Savings,Swansea,UK
3349,2019-09-07 00:00:00,DEB,AMZNMKTPLACE AMAZO,4.92,,4030.22,Amazon,Swansea,UK
3350,2019-09-07 00:00:00,CPT,LNK M&S SWANSEA,60.0,,4035.14,Cash,Swansea,UK
3351,2019-09-07 00:00:00,BP,SAVE THE CHANGE,1.72,,4095.14,Savings,Swansea,UK
3352,2019-08-07 00:00:00,DEB,TFW RAIL SERVICES,11.8,,4096.86,Travel,,
3353,2019-08-07 00:00:00,DEB,AMZN Mktp UK*M635I,7.43,,4108.66,Amazon,Swansea,UK
3354,2019-08-07 00:00:00,DEB,SWANSEA UNI - CATE,8.05,,4116.09,Dine Out,Swansea,UK
3355,2019-08-07 00:00:00,DD,THE GYM LTD,14.99,,4124.14,Fitness,Swansea,UK
3356,2019-08-07 00:00:00,BP,SAVE THE CHANGE,0.6,,4139.13,Savings,Swansea,UK
3357,2019-05-07 00:00:00,DEB,AMZNMktplace,14.4,,4139.73,Amazon,Swansea,UK
3358,2019-05-07 00:00:00,CPT,LNK TESCO FABIAN W,100.0,,4154.13,Cash,Swansea,UK
3359,2019-05-07 00:00:00,BP,SAVE THE CHANGE,0.19,,4254.13,Savings,Swansea,UK
3360,2019-04-07 00:00:00,DEB,AMZNMKTPLACE AMAZO,1.81,,4254.32,Amazon,Swansea,UK
3361,2019-03-07 00:00:00,FPO,AMELIA TERESZKIEWI,40.0,,4256.13,Services,Swansea,UK
3362,2019-03-07 00:00:00,DEB,Amazon.co.uk*M60AR,9.0,,4296.13,Amazon,Swansea,UK
3363,2019-03-07 00:00:00,BGC,GOOGLE IRELAND,,82.04,4305.13,Supplementary Income,Swansea,UK
3364,2019-02-07 00:00:00,DEP,CLUB LLOYDS WAIVED,,3.0,4223.09,Supplementary Income,Swansea,UK
3365,2019-02-07 00:00:00,PAY,CLUB LLOYDS FEE,3.0,,4220.09,Bills,Swansea,UK
3366,2019-02-07 00:00:00,DD,ZURICH,20.69,,4223.09,Insurance,Swansea,UK
3367,2019-02-07 00:00:00,BP,SAVE THE CHANGE,2.77,,4243.78,Savings,Swansea,UK
3368,2019-01-07 00:00:00,,INTEREST (GROSS),,5.54,4246.55,Interest,Swansea,UK
3369,2019-01-07 00:00:00,DEB,ZINCO LOUNGE,13.05,,4241.01,Dine Out,Swansea,UK
3370,2019-01-07 00:00:00,DEB,ZARA SWANSEA,15.99,,4254.06,Clothes,Swansea,UK
3371,2019-01-07 00:00:00,DEB,COFFEE#1 SWANSEA,10.75,,4270.05,Dine Out,Swansea,UK
3372,2019-01-07 00:00:00,DEB,TESCO STORE 3241,8.19,,4280.8,Groceries,,
3373,2019-01-07 00:00:00,DEB,MARKS&SPENCER PLC,1.0,,4288.99,Clothes,,
3374,2019-01-07 00:00:00,DEB,TFW RAIL SERVICES,77.5,,4289.99,Travel,,
3375,2019-01-07 00:00:00,DEB,BIRMINGHAM INT HOT,58.0,,4367.49,Hotels,Birmingham,UK
3376,2019-01-07 00:00:00,DEB,WASABI BIRMINGHAM,22.75,,4425.49,Dine Out,Birmingham,UK
3377,2019-01-07 00:00:00,DD,PRINCIPALITY BS,1163.58,,4448.24,Mortgage,Swansea,UK
3378,2019-01-07 00:00:00,DD,CC SWANSEA C.TAX,147.0,,5611.82,Bills,Swansea,UK
3379,2019-01-07 00:00:00,DD,GOOD ENERGY LTD,50.0,,5758.82,Bills,Swansea,UK
3380,2019-01-07 00:00:00,DD,DWR CYMRU W WATER,32.5,,5808.82,Bills,Swansea,UK
3381,2019-01-07 00:00:00,SO,ESAVINGS ACCOUNT,300.0,,5841.32,Savings,Swansea,UK
3382,2019-01-07 00:00:00,BP,SAVE THE CHANGE,0.6,,6141.32,Savings,Swansea,UK
3383,2019-01-07 00:00:00,CPT,LNK ESTATE AGENTS,50.0,,6141.92,Cash,Leeds,UK
3384,2019-01-07 00:00:00,CPT,LNK SWANSEA 1,100.0,,6191.92,Cash,Swansea,UK
3385,28/06/2019,DEB,WWW.III.CO.UK DE,1020.0,,6291.92,Investment,Nottingham,UK
3386,28/06/2019,DEB,ZINCO LOUNGE,14.4,,7311.92,Dine Out,Swansea,UK
3387,28/06/2019,DD,UCU B ACCOUNT,24.26,,7326.32,Others,Swansea,UK
3388,28/06/2019,BP,SAVE THE CHANGE,0.2,,7350.58,Savings,Swansea,UK
3389,28/06/2019,BGC,SWANSEA UNI - PAY,,3265.85,7350.78,Paycheck,Swansea,UK
3390,28/06/2019,BGC,GOOGLE IRELAND,,0.45,4084.93,Supplementary Income,Swansea,UK
3391,27/06/2019,DEB,WWW.III.CO.UK DE,2200.0,,4084.48,Investment,Nottingham,UK
3392,27/06/2019,DEB,TFW RAIL SERVICES,11.8,,6284.48,Travel,,
3393,27/06/2019,BP,SAVE THE CHANGE,2.31,,6296.28,Savings,Swansea,UK
3394,26/06/2019,DEB,Brontosaurus Vegan,25.34,,6298.59,Dine Out,Swansea,UK
3395,26/06/2019,DEB,MARKS&SPENCER PLC,14.2,,6323.93,Clothes,,
3396,26/06/2019,DEB,AMZNMKTPLACE AMAZO,6.15,,6338.13,Amazon,Swansea,UK
3397,26/06/2019,TFR,R LAWRENCE,,2000.0,6344.28,Supplementary Income,Swansea,UK
3398,25/06/2019,DEB,THE BIKE HUB,90.0,,4344.28,Other Shopping,,
3399,25/06/2019,CPT,LNK TESCO FABIAN W,40.0,,4434.28,Cash,Swansea,UK
3400,25/06/2019,BP,SAVE THE CHANGE,1.09,,4474.28,Savings,Swansea,UK
3401,24/06/2019,DEB,Amazon.co.uk*M62FO,56.03,,4475.37,Amazon,Swansea,UK
3402,24/06/2019,DEB,AMZNMktplace,24.94,,4531.4,Amazon,Swansea,UK
3403,24/06/2019,DEB,AMZNMktplace,19.95,,4556.34,Amazon,Swansea,UK
3404,24/06/2019,DEB,Audible.co.uk,7.99,,4576.29,Entertainment,Swansea,UK
3405,24/06/2019,DD,CORGI HOMEPLAN,14.75,,4584.28,Home Improvement,swansea,UK
3406,24/06/2019,BP,SAVE THE CHANGE,0.4,,4599.03,Savings,Swansea,UK
3407,24/06/2019,CPT,LNK 1 UNION STREET,60.0,,4599.43,Cash,Leicester,UK
3408,21/06/2019,DEB,SAINSBURY'S S/MKT,6.6,,4659.43,Groceries,,
3409,21/06/2019,CPT,LNK TESCO FABIAN W,60.0,,4666.03,Cash,Swansea,UK
3410,21/06/2019,DD,VIRGIN MEDIA PYMTS,29.0,,4726.03,Bills,Swansea,UK
3411,20/06/2019,DEB,WWW.III.CO.UK DE,4000.0,,4755.03,Investment,Nottingham,UK
3412,20/06/2019,CPT,LNK DIAMOND PROPER,80.0,,8755.03,Cash,Leeds,UK
3413,20/06/2019,BP,SAVE THE CHANGE,0.33,,8835.03,Savings,Swansea,UK
3414,19/06/2019,DEB,CANDLES & CO,21.99,,8835.36,Other Shopping,,
3415,19/06/2019,DEB,Audible.co.uk,18.0,,8857.35,Entertainment,Swansea,UK
3416,19/06/2019,DEB,POST OFFICE COUNTE,16.68,,8875.35,Others,Swansea,UK
3417,19/06/2019,TFR,R LAWRENCE,,4000.0,8892.03,Supplementary Income,Swansea,UK
3418,19/06/2019,BP,SAVE THE CHANGE,0.61,,4892.03,Savings,Swansea,UK
3419,18/06/2019,DEB,AMZNMKTPLACE AMAZO,18.52,,4892.64,Amazon,Swansea,UK
3420,18/06/2019,DEB,Amazon.co.uk*M64R1,6.87,,4911.16,Amazon,Swansea,UK
3421,18/06/2019,BP,SAVE THE CHANGE,0.33,,4918.03,Savings,Swansea,UK
3422,17/06/2019,DEB,Amazon.co.uk*M60D5,3.87,,4918.36,Amazon,Swansea,UK
3423,17/06/2019,DEB,LUL TICKET MACHINE,4.9,,4922.23,Travel,London,UK
3424,17/06/2019,DEB,TFW RAIL SERVICES,87.9,,4927.13,Travel,,
3425,17/06/2019,DD,O2,22.58,,5015.03,Other Shopping,Swansea,UK
3426,17/06/2019,CPT,LOYD LOYD 802 OXFO,50.0,,5037.61,Cash,Swansea,UK
3427,14/06/2019,CPT,LNK TESCO FABIAN W,120.0,,5087.61,Cash,Swansea,UK
3428,13/06/2019,DEB,WWW.III.CO.UK DE,2600.0,,5207.61,Investment,Nottingham,UK
3429,2019-12-06 00:00:00,TFR,R LAWRENCE,,2800.0,7807.61,Supplementary Income,Swansea,UK
3430,2019-12-06 00:00:00,BP,SAVE THE CHANGE,0.6,,5007.61,Savings,Swansea,UK
3431,2019-11-06 00:00:00,DEB,WWW.III.CO.UK DE,2000.0,,5008.21,Investment,Swansea,UK
3432,2019-11-06 00:00:00,DEB,NON-GBP PURCH FEE,0.5,,7008.21,Others,Swansea,UK
3433,2019-11-06 00:00:00,DEB,NON-GBP TRANS FEE,0.25,,7008.71,Others,Swansea,UK
3434,2019-11-06 00:00:00,DEB,TRAINAWAY APS,8.4,,7008.96,Travel,,
3435,2019-10-06 00:00:00,TFR,R LAWRENCE,,2000.0,7017.36,Supplementary Income,Swansea,UK
3436,2019-10-06 00:00:00,DEB,3830824-ONBB1,126.0,,5017.36,Others,Swansea,UK
3437,2019-10-06 00:00:00,CPT,LNK FABIAN WAY,50.0,,5143.36,Cash,Swansea,UK
3438,2019-10-06 00:00:00,BP,SAVE THE CHANGE,0.61,,5193.36,Savings,Swansea,UK
3439,2019-10-06 00:00:00,DEB,NON-GBP PURCH FEE,0.5,,5193.97,Others,Swansea,UK
3440,2019-10-06 00:00:00,DEB,NON-GBP TRANS FEE,0.25,,5194.47,Others,Swansea,UK
3441,2019-10-06 00:00:00,DEB,TRAINAWAY APS,8.39,,5194.72,Travel,,
3442,2019-07-06 00:00:00,DEB,FOREIGN CASH FEE,1.5,,5203.11,Travel,,
3443,2019-07-06 00:00:00,DEB,Shopping Domus Tri,197.37,,5204.61,Home Improvement,swansea,UK
3444,2019-07-06 00:00:00,DD,THE GYM LTD,14.99,,5401.98,Fitness,Swansea,UK
3445,2019-07-06 00:00:00,BP,SAVE THE CHANGE,1.24,,5416.97,Savings,Swansea,UK
3446,2019-06-06 00:00:00,DEB,NON-GBP PURCH FEE,0.5,,5418.21,Others,Swansea,UK
3447,2019-06-06 00:00:00,DEB,NON-GBP TRANS FEE,0.25,,5418.71,Others,Swansea,UK
3448,2019-06-06 00:00:00,DEB,TRAINAWAY APS,8.37,,5418.96,Travel,,
3449,2019-06-06 00:00:00,DEB,NON-GBP PURCH FEE,0.5,,5427.33,Others,Swansea,UK
3450,2019-06-06 00:00:00,DEB,NON-GBP TRANS FEE,0.25,,5427.83,Others,Swansea,UK
3451,2019-06-06 00:00:00,DEB,TRAINAWAY APS,8.39,,5428.08,Travel,,
3452,2019-06-06 00:00:00,BP,SAVE THE CHANGE,0.62,,5436.47,Savings,Swansea,UK
3453,2019-05-06 00:00:00,DEB,NON-GBP PURCH FEE,0.5,,5437.09,Others,Swansea,UK
3454,2019-05-06 00:00:00,DEB,NON-GBP TRANS FEE,0.25,,5437.59,Others,Swansea,UK
3455,2019-05-06 00:00:00,DEB,TRAINAWAY APS,8.38,,5437.84,Travel,,
3456,2019-05-06 00:00:00,BP,SAVE THE CHANGE,0.2,,5446.22,Savings,Swansea,UK
3457,2019-04-06 00:00:00,DEP,CLUB LLOYDS WAIVED,,3.0,5446.42,Supplementary Income,Swansea,UK
3458,2019-04-06 00:00:00,PAY,CLUB LLOYDS FEE,3.0,,5443.42,Bills,Swansea,UK
3459,2019-04-06 00:00:00,DEB,MEIA DUZIA,12.8,,5446.42,Other Shopping,,
3460,2019-04-06 00:00:00,BP,SAVE THE CHANGE,2.34,,5459.22,Savings,Swansea,UK
3461,2019-03-06 00:00:00,,INTEREST (GROSS),,6.48,5461.56,Interest,Swansea,UK
3462,2019-03-06 00:00:00,DEB,NON-GBP PURCH FEE,0.5,,5455.08,Others,Swansea,UK
3463,2019-03-06 00:00:00,DEB,NON-GBP TRANS FEE,0.26,,5455.58,Others,Swansea,UK
3464,2019-03-06 00:00:00,DEB,RESTAURANTE DA TER,8.79,,5455.84,Dine Out,London,UK
3465,2019-03-06 00:00:00,DEB,NON-GBP PURCH FEE,0.5,,5464.63,Others,Swansea,UK
3466,2019-03-06 00:00:00,DEB,NON-GBP TRANS FEE,0.25,,5465.13,Others,Swansea,UK
3467,2019-03-06 00:00:00,DEB,TRAINAWAY APS,8.37,,5465.38,Travel,,
3468,2019-03-06 00:00:00,DEB,TFW RAIL SERVICES,50.4,,5473.75,Travel,,
3469,2019-03-06 00:00:00,DEB,MINIPRECO LOIOS 2,20.65,,5524.15,Groceries,Porto,Portugal
3470,2019-03-06 00:00:00,DEB,M&S SIMPLY FOOD-SS,7.65,,5544.8,Groceries,Swansea,UK
3471,2019-03-06 00:00:00,DEB,WWW.III.CO.UK DE,1000.0,,5552.45,Investment,Swansea,UK
3472,2019-03-06 00:00:00,DEB,SAINSBURY'S S/MKT,19.8,,6552.45,Groceries,,
3473,2019-03-06 00:00:00,DD,PRINCIPALITY BS,957.26,,6572.25,Mortgage,Swansea,UK
3474,2019-03-06 00:00:00,DD,CC SWANSEA C.TAX,147.0,,7529.51,Bills,Swansea,UK
3475,2019-03-06 00:00:00,DD,GOOD ENERGY LTD,50.0,,7676.51,Bills,Swansea,UK
3476,2019-03-06 00:00:00,DD,DWR CYMRU W WATER,32.5,,7726.51,Bills,Swansea,UK
3477,2019-03-06 00:00:00,DD,ZURICH,20.69,,7759.01,Insurance,Swansea,UK
3478,2019-03-06 00:00:00,SO,ESAVINGS ACCOUNT,300.0,,7779.7,Savings,Swansea,UK
3479,31/05/2019,TFR,R LAWRENCE,,1000.0,8079.7,Supplementary Income,Swansea,UK
3480,31/05/2019,DEB,WWW.III.CO.UK DE,200.0,,7079.7,Investment,Nottingham,UK
3481,31/05/2019,DD,UCU B ACCOUNT,24.26,,7279.7,Others,Swansea,UK
3482,31/05/2019,BGC,SWANSEA UNI - PAY,,3265.85,7303.96,Paycheck,Swansea,UK
3483,30/05/2019,CPT,LNK TESCO FABIAN W,60.0,,4038.11,Cash,Swansea,UK
3484,30/05/2019,BP,SAVE THE CHANGE,0.23,,4098.11,Savings,Swansea,UK
3485,29/05/2019,DEB,AMZNMktplace,1.77,,4098.34,Amazon,Swansea,UK
3486,29/05/2019,CPT,LNK TESCO FABIAN W,40.0,,4100.11,Cash,Swansea,UK
3487,29/05/2019,BP,SAVE THE CHANGE,2.27,,4140.11,Savings,Swansea,UK
3488,28/05/2019,DEB,AMZNMktplace,12.49,,4142.38,Amazon,Swansea,UK
3489,28/05/2019,DEB,SWANSEA FOOD CENTR,7.46,,4154.87,Dine Out,Swansea,UK
3490,28/05/2019,DEB,AMZNMKTPLACE AMAZO,3.33,,4162.33,Amazon,Swansea,UK
3491,28/05/2019,DEB,AMZN MKTP UK*MN36N,5.99,,4165.66,Amazon,Swansea,UK
3492,28/05/2019,DEB,WWW.III.CO.UK DE,5000.0,,4171.65,Investment,Nottingham,UK
3493,28/05/2019,DEB,POST OFFICE COUNTE,27.62,,9171.65,Others,Swansea,UK
3494,28/05/2019,DEB,Brontosaurus Vegan,16.95,,9199.27,Dine Out,Swansea,UK
3495,28/05/2019,DEB,MARKS&SPENCER PLC,8.9,,9216.22,Clothes,,
3496,28/05/2019,DEB,AMAZON.CO.UK*MN9V3,12.99,,9225.12,Amazon,Swansea,UK
3497,28/05/2019,BP,SAVE THE CHANGE,0.01,,9238.11,Savings,Swansea,UK
3498,28/05/2019,CPT,LNK M&S SWANSEA,50.0,,9238.12,Cash,Swansea,UK
3499,28/05/2019,TFR,R LAWRENCE  25MAY19,,5000.0,9288.12,Supplementary Income,Swansea,UK
3500,24/05/2019,CPT,LNK TESCO FABIAN W,50.0,,4288.12,Cash,Swansea,UK
3501,24/05/2019,DEB,TESCO STORES 4628,5.0,,4338.12,Groceries,,
3502,24/05/2019,DEB,Audible.co.uk,7.99,,4343.12,Entertainment,Swansea,UK
3503,24/05/2019,BP,SAVE THE CHANGE,1.48,,4351.11,Savings,Swansea,UK
3504,23/05/2019,DEB,NON-GBP PURCH FEE,0.5,,4352.59,Others,Swansea,UK
3505,23/05/2019,DEB,NON-GBP TRANS FEE,15.82,,4353.09,Others,Swansea,UK
3506,23/05/2019,DEB,2160701-KEGHB,529.11,,4368.91,Others,Swansea,UK
3507,23/05/2019,DEB,AMZN MKTP UK*MN1H1,18.41,,4898.02,Amazon,Swansea,UK
3508,22/05/2019,CPT,LNK TESCO FABIAN W,50.0,,4916.43,Cash,Swansea,UK
3509,22/05/2019,DD,CORGI HOMEPLAN,14.75,,4966.43,Home Improvement,swansea,UK
3510,21/05/2019,DD,VIRGIN MEDIA PYMTS,29.0,,4981.18,Bills,Swansea,UK
3511,21/05/2019,BP,SAVE THE CHANGE,2.5,,5010.18,Savings,Swansea,UK
3512,20/05/2019,DEB,Amazon.co.uk*MN9ZF,16.33,,5012.68,Amazon,Swansea,UK
3513,20/05/2019,DEB,AMAZON.CO.UK*MN6LS,9.79,,5029.01,Amazon,Swansea,UK
3514,20/05/2019,DEB,Brontosaurus Vegan,29.18,,5038.8,Dine Out,Swansea,UK
3515,20/05/2019,DEB,MARKS&SPENCER PLC,4.7,,5067.98,Clothes,,
3516,20/05/2019,DEB,SWANSEA UNI - CATE,13.5,,5072.68,Dine Out,Swansea,UK
3517,20/05/2019,CPT,LNK TESCO FABIAN W,60.0,,5086.18,Cash,Swansea,UK
3518,20/05/2019,CPT,LNK SWANSEA CITY C,50.0,,5146.18,Cash,Swansea,UK
3519,17/05/2019,CPT,LNK TESCO FABIAN W,60.0,,5196.18,Cash,Swansea,UK
3520,16/05/2019,DD,O2,27.14,,5256.18,Other Shopping,Swansea,UK
3521,16/05/2019,BP,SAVE THE CHANGE,0.49,,5283.32,Savings,Swansea,UK
3522,15/05/2019,DEB,NON-GBP PURCH FEE,0.5,,5283.81,Others,Swansea,UK
3523,15/05/2019,DEB,NON-GBP TRANS FEE,0.31,,5284.31,Others,Swansea,UK
3524,15/05/2019,DEB,HMSHOST AMSTERDAM,10.51,,5284.62,Dine Out,Amsterdam,Netherlands
3525,15/05/2019,BP,SAVE THE CHANGE,1.27,,5295.13,Savings,Swansea,UK
3526,14/05/2019,DEB,SAINSBURY'S S/MKT,9.9,,5296.4,Groceries,,
3527,14/05/2019,DEB,AMZNMKTPLACE AMAZO,2.32,,5306.3,Amazon,Swansea,UK
3528,14/05/2019,DEB,DOUBLETREE BY HILT,105.0,,5308.62,Hotels,,
3529,14/05/2019,CPT,LNK FABIAN WAY,50.0,,5413.62,Cash,Swansea,UK
3530,14/05/2019,DEB,NON-GBP PURCH FEE,0.5,,5463.62,Others,Swansea,UK
3531,14/05/2019,DEB,NON-GBP TRANS FEE,0.28,,5464.12,Others,Swansea,UK
3532,14/05/2019,DEB,BAR BIGO,9.51,,5464.4,Dine Out,Paris,France
3533,14/05/2019,BP,SAVE THE CHANGE,0.37,,5473.91,Savings,Swansea,UK
3534,13/05/2019,DEB,NH GENOVA CENTRO,740.63,,5474.28,Hotels,Genova,Italy
3535,13/05/2019,DEB,NON-GBP CASH FEE,1.5,,6214.91,Others,Swansea,UK
3536,13/05/2019,DEB,NON-GBP TRANS FEE,2.58,,6216.41,Others,Swansea,UK
3537,13/05/2019,DEB,ABN-AMRO,86.45,,6218.99,Travel,,
3538,13/05/2019,BP,SAVE THE CHANGE,0.39,,6305.44,Savings,Swansea,UK
3539,2019-10-05 00:00:00,DEB,NON-GBP PURCH FEE,0.5,,6305.83,Others,Swansea,UK
3540,2019-10-05 00:00:00,DEB,NON-GBP TRANS FEE,0.61,,6306.33,Others,Swansea,UK
3541,2019-10-05 00:00:00,DEB,JAPAN RESTAURANT,20.61,,6306.94,Dine Out,,
3542,2019-10-05 00:00:00,BP,SAVE THE CHANGE,0.69,,6327.55,Savings,Swansea,UK
3543,2019-09-05 00:00:00,DEB,NON-GBP PURCH FEE,0.5,,6328.24,Others,Swansea,UK
3544,2019-09-05 00:00:00,DEB,NON-GBP TRANS FEE,0.76,,6328.74,Others,Swansea,UK
3545,2019-09-05 00:00:00,DEB,CELIO 6309,25.74,,6329.5,Clothes,,
3546,2019-09-05 00:00:00,DEB,NON-GBP PURCH FEE,0.5,,6355.24,Others,Swansea,UK
3547,2019-09-05 00:00:00,DEB,NON-GBP TRANS FEE,0.25,,6355.74,Others,Swansea,UK
3548,2019-09-05 00:00:00,DEB,H & M  5,8.57,,6355.99,Clothes,,
3549,2019-08-05 00:00:00,BP,SAVE THE CHANGE,2.51,,6364.56,Savings,Swansea,UK
3550,2019-07-05 00:00:00,DEB,Amazon.co.uk*MN59F,6.29,,6367.07,Amazon,Swansea,UK
3551,2019-07-05 00:00:00,DEB,NON-GBP PURCH FEE,0.5,,6373.36,Others,Swansea,UK
3552,2019-07-05 00:00:00,DEB,NON-GBP TRANS FEE,0.84,,6373.86,Others,Swansea,UK
3553,2019-07-05 00:00:00,DEB,H & M  5,28.32,,6374.7,Clothes,,
3554,2019-07-05 00:00:00,DEB,NON-GBP CASH FEE,1.5,,6403.02,Others,Swansea,UK
3555,2019-07-05 00:00:00,DEB,NON-GBP TRANS FEE,5.13,,6404.52,Others,Swansea,UK
3556,2019-07-05 00:00:00,DEB,BANCA CARIGE CR GE,171.76,,6409.65,Travel,,
3557,2019-07-05 00:00:00,DEB,TFW RAIL SERVICES,50.4,,6581.41,Travel,,
3558,2019-07-05 00:00:00,DEB,AMZNMKTPLACE AMAZO,5.48,,6631.81,Amazon,Swansea,UK
3559,2019-07-05 00:00:00,DD,THE GYM LTD,14.99,,6637.29,Fitness,Swansea,UK
3560,2019-03-05 00:00:00,DD,ASSURANT INTER LTD,21.15,,6652.28,Insurance,Swansea,UK
3561,2019-03-05 00:00:00,BP,SAVE THE CHANGE,0.25,,6673.43,Savings,Swansea,UK
3562,2019-02-05 00:00:00,DEP,CLUB LLOYDS WAIVED,,3.0,6673.68,Supplementary Income,Swansea,UK
3563,2019-02-05 00:00:00,PAY,CLUB LLOYDS FEE,3.0,,6670.68,Bills,Swansea,UK
3564,2019-02-05 00:00:00,DEB,Lush UK,16.95,,6673.68,Other Shopping,,
3565,2019-02-05 00:00:00,DEB,SAINSBURYS S/MKTS,16.8,,6690.63,Groceries,,
3566,2019-02-05 00:00:00,CPT,LNK TESCO FABIAN W,60.0,,6707.43,Cash,Swansea,UK
3567,2019-02-05 00:00:00,BP,SAVE THE CHANGE,0.05,,6767.43,Savings,Swansea,UK
3568,2019-01-05 00:00:00,,INTEREST (GROSS),,6.12,6767.48,Interest,Swansea,UK
3569,2019-01-05 00:00:00,DEB,SAINSBURYS S/MKTS,15.0,,6761.36,Groceries,,
3570,2019-01-05 00:00:00,DEB,TESCO STORES 4628,3.95,,6776.36,Groceries,,
3571,2019-01-05 00:00:00,CPT,LNK SAINSBURYS BAN,50.0,,6780.31,Cash,,
3572,2019-01-05 00:00:00,DD,PRINCIPALITY BS,957.26,,6830.31,Mortgage,Swansea,UK
3573,2019-01-05 00:00:00,DD,CC SWANSEA C.TAX,147.0,,7787.57,Bills,Swansea,UK
3574,2019-01-05 00:00:00,DD,GOOD ENERGY LTD,97.0,,7934.57,Bills,Swansea,UK
3575,2019-01-05 00:00:00,DD,DWR CYMRU W WATER,32.5,,8031.57,Bills,Swansea,UK
3576,2019-01-05 00:00:00,DD,ZURICH,20.69,,8064.07,Insurance,Swansea,UK
3577,2019-01-05 00:00:00,SO,ESAVINGS ACCOUNT,300.0,,8084.76,Savings,Swansea,UK
3578,30/04/2019,DD,UCU B ACCOUNT,24.26,,8384.76,Others,Swansea,UK
3579,30/04/2019,BP,SAVE THE CHANGE,1.18,,8409.02,Savings,Swansea,UK
3580,30/04/2019,BGC,SWANSEA UNI - PAY,,3265.85,8410.2,Paycheck,Swansea,UK
3581,29/04/2019,DEB,WWW.III.CO.UK DE,3000.0,,5144.35,Investment,Nottingham,UK
3582,29/04/2019,DEB,HATHWAY HOUSE ACCO,55.0,,8144.35,Hotels,Bristol,
3583,29/04/2019,DEB,PAYPAL *DISC HEALT,39.95,,8199.35,Services,Swansea,UK
3584,29/04/2019,DEB,Brontosaurus Vegan,18.57,,8239.3,Dine Out,Swansea,UK
3585,29/04/2019,DEB,POST OFFICE COUNTE,17.8,,8257.87,Others,Swansea,UK
3586,29/04/2019,DEB,THE BODY SHOP INTL,15.0,,8275.67,Other Shopping,,
3587,29/04/2019,DEB,MARKS&SPENCER PLC,8.5,,8290.67,Clothes,,
3588,29/04/2019,BP,SAVE THE CHANGE,0.66,,8299.17,Savings,Swansea,UK
3589,29/04/2019,TFR,R LAWRENCE  28APR19,,1000.0,8299.83,Supplementary Income,Swansea,UK
3590,26/04/2019,DEB,AMZNMktplace,2.34,,7299.83,Amazon,Swansea,UK
3591,26/04/2019,CPT,LNK TESCO FABIAN W,60.0,,7302.17,Cash,Swansea,UK
3592,25/04/2019,CPT,LNK TESCO FABIAN W,100.0,,7362.17,Cash,Swansea,UK
3593,25/04/2019,BP,SAVE THE CHANGE,0.01,,7462.17,Savings,Swansea,UK
3594,24/04/2019,DEB,Audible.co.uk,7.99,,7462.18,Entertainment,Swansea,UK
3595,24/04/2019,BP,SAVE THE CHANGE,1.06,,7470.17,Savings,Swansea,UK
3596,23/04/2019,DEB,WM MORRISONS STORE,44.91,,7471.23,Groceries,,
3597,23/04/2019,DEB,Brontosaurus Vegan,23.62,,7516.14,Dine Out,Swansea,UK
3598,23/04/2019,DEB,AMAZON.CO.UK*MZ3T6,11.81,,7539.76,Amazon,Swansea,UK
3599,23/04/2019,DEB,MARKS&SPENCER PLC,8.8,,7551.57,Clothes,,
3600,23/04/2019,DEB,COFFEE#1 SWANSEA,3.8,,7560.37,Dine Out,Swansea,UK
3601,23/04/2019,CPT,LNK TESCO FABIAN W,60.0,,7564.17,Cash,Swansea,UK
3602,23/04/2019,DD,VIRGIN MEDIA PYMTS,29.0,,7624.17,Bills,Swansea,UK
3603,23/04/2019,DD,CORGI HOMEPLAN,14.75,,7653.17,Home Improvement,swansea,UK
3604,18/04/2019,CPT,LNK TESCO FABIAN W,50.0,,7667.92,Cash,Swansea,UK
3605,18/04/2019,BP,SAVE THE CHANGE,0.47,,7717.92,Savings,Swansea,UK
3606,17/04/2019,DEB,AMZNMktplace,7.93,,7718.39,Amazon,Swansea,UK
3607,17/04/2019,DEB,AMZNMKTPLACE AMAZO,3.6,,7726.32,Amazon,Swansea,UK
3608,16/04/2019,CPT,LNK FABIAN WAY,150.0,,7729.92,Cash,Swansea,UK
3609,16/04/2019,DD,O2,18.94,,7879.92,Other Shopping,Swansea,UK
3610,16/04/2019,BP,SAVE THE CHANGE,1.62,,7898.86,Savings,Swansea,UK
3611,15/04/2019,DEB,SAINSBURY'S S/MKT,20.06,,7900.48,Groceries,,
3612,15/04/2019,DEB,Brontosaurus Vegan,14.72,,7920.54,Dine Out,Swansea,UK
3613,15/04/2019,DEB,MARKS&SPENCER PLC,6.7,,7935.26,Clothes,,
3614,15/04/2019,DEB,KLM UK  074341,304.9,,7941.96,Travel,,
3615,15/04/2019,CPT,LNK TESCO FABIAN W,250.0,,8246.86,Cash,Swansea,UK
3616,15/04/2019,CPT,LOYD LOYD 802 OXFO,40.0,,8496.86,Cash,Swansea,UK
3617,2019-12-04 00:00:00,BP,SAVE THE CHANGE,0.12,,8536.86,Savings,Swansea,UK
3618,2019-11-04 00:00:00,DEB,AMZNMktplace,14.88,,8536.98,Amazon,Swansea,UK
3619,2019-11-04 00:00:00,BP,SAVE THE CHANGE,0.36,,8551.86,Savings,Swansea,UK
3620,2019-10-04 00:00:00,DEB,EASYJET   000EWX,85.64,,8552.22,Travel,,
3621,2019-10-04 00:00:00,DEB,EXPEDIA 7425718119,3.0,,8637.86,Travel,,
3622,2019-10-04 00:00:00,CPT,LNK TESCO FABIAN W,40.0,,8640.86,Cash,Swansea,UK
3623,2019-09-04 00:00:00,CPT,LNK TESCO FABIAN W,40.0,,8680.86,Cash,Swansea,UK
3624,2019-09-04 00:00:00,BP,SAVE THE CHANGE,2.13,,8720.86,Savings,Swansea,UK
3625,2019-08-04 00:00:00,DEB,THE GYM LTD,29.99,,8722.99,Fitness,Swansea,UK
3626,2019-08-04 00:00:00,DEB,AMZNMktplace,15.66,,8752.98,Amazon,Swansea,UK
3627,2019-08-04 00:00:00,DEB,Brontosaurus Vegan,19.02,,8768.64,Dine Out,Swansea,UK
3628,2019-08-04 00:00:00,DEB,MARKS&SPENCER PLC,7.2,,8787.66,Clothes,,
3629,2019-08-04 00:00:00,DD,LV LIFE,37.12,,8794.86,Insurance,Swansea,UK
3630,2019-08-04 00:00:00,BP,SAVE THE CHANGE,0.01,,8831.98,Savings,Swansea,UK
3631,2019-05-04 00:00:00,CPT,LNK M&S SWANSEA,50.0,,8831.99,Cash,Swansea,UK
3632,2019-05-04 00:00:00,DEB,THE GYM LTD,7.99,,8881.99,Fitness,Swansea,UK
3633,2019-05-04 00:00:00,BP,SAVE THE CHANGE,0.19,,8889.98,Savings,Swansea,UK
3634,2019-04-04 00:00:00,DEB,WWW.III.CO.UK DE,5000.0,,8890.17,Investment,Swansea,UK
3635,2019-04-04 00:00:00,DEB,AMZNMktplace,5.81,,13890.17,Amazon,Swansea,UK
3636,2019-04-04 00:00:00,BP,SAVE THE CHANGE,1.23,,13895.98,Savings,Swansea,UK
3637,2019-03-04 00:00:00,DEB,AMZNMktplace,24.28,,13897.21,Amazon,Swansea,UK
3638,2019-03-04 00:00:00,DEB,Amazon.co.uk*MZ275,10.49,,13921.49,Amazon,Swansea,UK
3639,2019-03-04 00:00:00,CPT,LNK TESCO FABIAN W,40.0,,13931.98,Cash,Swansea,UK
3640,2019-03-04 00:00:00,DD,ASSURANT INTER LTD,21.15,,13971.98,Insurance,Swansea,UK
3641,2019-02-04 00:00:00,DEP,CLUB LLOYDS WAIVED,,3.0,13993.13,Supplementary Income,Swansea,UK
3642,2019-02-04 00:00:00,PAY,CLUB LLOYDS FEE,3.0,,13990.13,Bills,Swansea,UK
3643,2019-02-04 00:00:00,DD,ZURICH,20.69,,13993.13,Insurance,Swansea,UK
3644,2019-02-04 00:00:00,BP,SAVE THE CHANGE,2.47,,14013.82,Savings,Swansea,UK
3645,2019-01-04 00:00:00,,INTEREST (GROSS),,6.33,14016.29,Interest,Swansea,UK
3646,2019-01-04 00:00:00,DEB,Brontosaurus Vegan,16.62,,14009.96,Dine Out,Swansea,UK
3647,2019-01-04 00:00:00,DEB,POST OFFICE COUNTE,12.76,,14026.58,Others,Swansea,UK
3648,2019-01-04 00:00:00,DEB,MARKS&SPENCER PLC,7.1,,14039.34,Clothes,,
3649,2019-01-04 00:00:00,DEB,PAYPAL *JAKUBSTADT,81.05,,14046.44,Services,Swansea,UK
3650,2019-01-04 00:00:00,DD,PRINCIPALITY BS,957.26,,14127.49,Mortgage,Swansea,UK
3651,2019-01-04 00:00:00,DD,CC SWANSEA C.TAX,145.69,,15084.75,Bills,Swansea,UK
3652,2019-01-04 00:00:00,DD,GOOD ENERGY LTD,97.0,,15230.44,Bills,Swansea,UK
3653,2019-01-04 00:00:00,DD,DWR CYMRU W WATER,32.5,,15327.44,Bills,Swansea,UK
3654,2019-01-04 00:00:00,SO,ESAVINGS ACCOUNT,300.0,,15359.94,Savings,Swansea,UK
3655,2019-01-04 00:00:00,CPT,LNK 1 UNION STREET,40.0,,15659.94,Cash,Leicester,UK
3656,29/03/2019,CPT,LNK TESCO FABIAN W,40.0,,15699.94,Cash,Swansea,UK
3657,29/03/2019,DD,UCU B ACCOUNT,24.26,,15739.94,Others,Swansea,UK
3658,29/03/2019,BP,SAVE THE CHANGE,0.5,,15764.2,Savings,Swansea,UK
3659,29/03/2019,BGC,SWANSEA UNI - PAY,,3251.36,15764.7,Paycheck,Swansea,UK
3660,28/03/2019,DEB,AMZN MKTP UK*MZ4YK,2.5,,12513.34,Amazon,Swansea,UK
3661,27/03/2019,BP,SAVE THE CHANGE,0.7,,12515.84,Savings,Swansea,UK
3662,26/03/2019,DEB,SAINSBURY'S S/MKT,29.3,,12516.54,Groceries,,
3663,26/03/2019,BP,SAVE THE CHANGE,1.41,,12545.84,Savings,Swansea,UK
3664,25/03/2019,DEB,ZINCO LOUNGE,14.75,,12547.25,Dine Out,Swansea,UK
3665,25/03/2019,DEB,Brontosaurus Vegan,15.05,,12562.0,Dine Out,Swansea,UK
3666,25/03/2019,DEB,MARKS&SPENCER PLC,10.8,,12577.05,Clothes,,
3667,25/03/2019,DEB,Audible.co.uk,7.99,,12587.85,Entertainment,Swansea,UK
3668,25/03/2019,CPT,LNK TESCO FABIAN W,50.0,,12595.84,Cash,Swansea,UK
3669,25/03/2019,BP,SAVE THE CHANGE,0.69,,12645.84,Savings,Swansea,UK
3670,22/03/2019,CPT,LNK TESCO FABIAN W,30.0,,12646.53,Cash,Swansea,UK
3671,22/03/2019,DD,CORGI HOMEPLAN,14.75,,12676.53,Home Improvement,swansea,UK
3672,22/03/2019,DEB,NON-GBP PURCH FEE,0.5,,12691.28,Others,Swansea,UK
3673,22/03/2019,DEB,NON-GBP TRANS FEE,6.64,,12691.78,Others,Swansea,UK
3674,22/03/2019,DEB,B.COM 2160701-KEGH,222.31,,12698.42,,,
3675,22/03/2019,BP,SAVE THE CHANGE,0.56,,12920.73,Savings,Swansea,UK
3676,21/03/2019,DEB,AMZN Mktp UK*MW55R,17.7,,12921.29,Amazon,Swansea,UK
3677,21/03/2019,DEB,KLM UK  074341,443.74,,12938.99,Travel,,
3678,21/03/2019,DD,VIRGIN MEDIA PYMTS,29.0,,13382.73,Bills,Swansea,UK
3679,21/03/2019,BP,SAVE THE CHANGE,0.97,,13411.73,Savings,Swansea,UK
3680,20/03/2019,DEB,AMZN Mktp UK*MW0N1,9.03,,13412.7,Amazon,Swansea,UK
3681,20/03/2019,DEB,EXPEDIA 7420654555,3.0,,13421.73,Travel,,
3682,20/03/2019,BP,SAVE THE CHANGE,0.86,,13424.73,Savings,Swansea,UK
3683,19/03/2019,DEB,AMZN Mktp UK*MW1XF,6.14,,13425.59,Amazon,Swansea,UK
3684,19/03/2019,CPT,LNK FABIAN WAY,50.0,,13431.73,Cash,Swansea,UK
3685,19/03/2019,BP,SAVE THE CHANGE,0.3,,13481.73,Savings,Swansea,UK
3686,18/03/2019,DEB,THE BIKE HUB,20.0,,13482.03,Other Shopping,,
3687,18/03/2019,DEB,MARKS&SPENCER PLC,4.7,,13502.03,Clothes,,
3688,18/03/2019,DD,O2,17.95,,13506.73,Other Shopping,Swansea,UK
3689,18/03/2019,CPT,LNK M&S SWANSEA,40.0,,13524.68,Cash,Swansea,UK
3690,15/03/2019,CPT,LNK TESCO FABIAN W,40.0,,13564.68,Cash,Swansea,UK
3691,15/03/2019,BGC,SWANSEA UNIVERSITY,,264.95,13604.68,Supplementary Income,Swansea,UK
3692,14/03/2019,BP,SAVE THE CHANGE,0.5,,13339.73,Savings,Swansea,UK
3693,13/03/2019,DEB,AMZN MKTP UK*MW1F6,15.9,,13340.23,Amazon,Swansea,UK
3694,13/03/2019,DEB,TESCO STORES 4628,6.6,,13356.13,Groceries,,
3695,2019-12-03 00:00:00,CPT,LNK TESCO FABIAN W,40.0,,13362.73,Cash,Swansea,UK
3696,2019-12-03 00:00:00,BP,SAVE THE CHANGE,0.67,,13402.73,Savings,Swansea,UK
3697,2019-11-03 00:00:00,DEB,Brontosaurus Vegan,33.72,,13403.4,Dine Out,Swansea,UK
3698,2019-11-03 00:00:00,DEB,MARKS&SPENCER PLC,5.0,,13437.12,Clothes,,
3699,2019-11-03 00:00:00,DEB,Amazon Prime*MW23K,79.0,,13442.12,Amazon,Swansea,UK
3700,2019-11-03 00:00:00,DEB,AMZN Mktp UK*MW6U6,7.61,,13521.12,Amazon,Swansea,UK
3701,2019-08-03 00:00:00,CPT,LNK FABIAN WAY,50.0,,13528.73,Cash,Swansea,UK
3702,2019-08-03 00:00:00,DD,LV LIFE,37.12,,13578.73,Insurance,Swansea,UK
3703,2019-08-03 00:00:00,BP,SAVE THE CHANGE,0.99,,13615.85,Savings,Swansea,UK
3704,2019-07-03 00:00:00,DEB,AMAZON.CO.UK*MW8G9,13.01,,13616.84,Amazon,Swansea,UK
3705,2019-07-03 00:00:00,CPT,LNK TESCO FABIAN W,40.0,,13629.85,Cash,Swansea,UK
3706,2019-07-03 00:00:00,BP,SAVE THE CHANGE,0.51,,13669.85,Savings,Swansea,UK
3707,2019-06-03 00:00:00,DEB,AMZN MKTP UK*MW4GI,23.49,,13670.36,Amazon,Swansea,UK
3708,2019-06-03 00:00:00,CPT,LNK FABIAN WAY,50.0,,13693.85,Cash,Swansea,UK
3709,2019-06-03 00:00:00,BP,SAVE THE CHANGE,0.27,,13743.85,Savings,Swansea,UK
3710,2019-05-03 00:00:00,DEB,AMZN Mktp UK*MW6J9,35.73,,13744.12,Amazon,Swansea,UK
3711,2019-05-03 00:00:00,BP,SAVE THE CHANGE,2.2,,13779.85,Savings,Swansea,UK
3712,2019-04-03 00:00:00,DEP,CLUB LLOYDS WAIVED,,3.0,13782.05,Amazon,Swansea,UK
3713,2019-04-03 00:00:00,PAY,CLUB LLOYDS FEE,3.0,,13779.05,Bills,Swansea,UK
3714,2019-04-03 00:00:00,DEB,Amazon.co.uk*MW4OW,16.15,,13782.05,Supplementary Income,Swansea,UK
3715,2019-04-03 00:00:00,DEB,MARKS&SPENCER PLC,9.2,,13798.2,Clothes,,
3716,2019-04-03 00:00:00,DEB,COFFEE#1 SWANSEA,8.8,,13807.4,Dine Out,Swansea,UK
3717,2019-04-03 00:00:00,DEB,AMZN Mktp UK*MW8PN,11.65,,13816.2,Amazon,Swansea,UK
3718,2019-01-03 00:00:00,,INTEREST (GROSS),,5.71,13827.85,Interest,Swansea,UK
3719,2019-01-03 00:00:00,CPT,LNK TESCO FABIAN W,50.0,,13822.14,Cash,Swansea,UK
3720,2019-01-03 00:00:00,DD,PRINCIPALITY BS,957.26,,13872.14,Mortgage,Swansea,UK
3721,2019-01-03 00:00:00,DD,GOOD ENERGY LTD,97.0,,14829.4,Bills,Swansea,UK
3722,2019-01-03 00:00:00,DD,AVIVA LIFE,46.46,,14926.4,Insurance,Swansea,UK
3723,2019-01-03 00:00:00,DD,DWR CYMRU W WATER,23.5,,14972.86,Bills,Swansea,UK
3724,2019-01-03 00:00:00,DD,ASSURANT INTER LTD,21.15,,14996.36,Insurance,Swansea,UK
3725,2019-01-03 00:00:00,DD,ZURICH,20.69,,15017.51,Insurance,Swansea,UK
3726,2019-01-03 00:00:00,DD,CC SWANSEA C.TAX,13.0,,15038.2,Bills,Swansea,UK
3727,2019-01-03 00:00:00,SO,ESAVINGS ACCOUNT,300.0,,15051.2,Savings,Swansea,UK
3728,2019-01-03 00:00:00,BGC,SWANSEA UNIVERSITY,,123.2,15351.2,Supplementary Income,Swansea,UK
3729,28/02/2019,DD,UCU B ACCOUNT,24.26,,15228.0,Others,Swansea,UK
3730,28/02/2019,BGC,SWANSEA UNI - PAY,,3250.96,15252.26,Paycheck,Swansea,UK
3731,28/02/2019,BGC,MIDDLESEX UNIV,,404.95,12001.3,Supplementary Income,Swansea,UK
3732,27/02/2019,CPT,LNK TESCO FABIAN W,20.0,,11596.35,Cash,Swansea,UK
3733,26/02/2019,BP,SAVE THE CHANGE,1.79,,11616.35,Savings,Swansea,UK
3734,25/02/2019,DEB,NON-GBP PURCH FEE,0.5,,11618.14,Others,Swansea,UK
3735,25/02/2019,DEB,NON-GBP TRANS FEE,11.52,,11618.64,Others,Swansea,UK
3736,25/02/2019,DEB,VEGAN LAUNCH,385.59,,11630.16,Dine Out,,
3737,25/02/2019,DEB,Amazon.co.uk*MI64R,12.37,,12015.75,Amazon,Swansea,UK
3738,25/02/2019,DEB,AMZN MKTP UK*MI4CC,8.99,,12028.12,Amazon,Swansea,UK
3739,25/02/2019,DEB,AMZN Mktp UK*MI93A,5.99,,12037.11,Amazon,Swansea,UK
3740,25/02/2019,DEB,SHARE DEALINGS LEE,5000.0,,12043.1,Services,Swansea,UK
3741,25/02/2019,DEB,Brontosaurus Vegan,20.99,,17043.1,Dine Out,Swansea,UK
3742,25/02/2019,DEB,POUNDSTRETCHER 270,4.29,,17064.09,Groceries,,
3743,25/02/2019,DEB,Audible.co.uk,7.99,,17068.38,Entertainment,Swansea,UK
3744,25/02/2019,DEB,SHARE DEALINGS LEE,25.0,,17076.37,Services,Swansea,UK
3745,25/02/2019,CPT,LNK TESCO FABIAN W,40.0,,17101.37,Cash,Swansea,UK
3746,22/02/2019,DEB,SAINSBURY'S S/MKT,11.0,,17141.37,Groceries,,
3747,22/02/2019,CPT,LNK TESCO FABIAN W,40.0,,17152.37,Cash,Swansea,UK
3748,22/02/2019,DD,CORGI HOMEPLAN,14.75,,17192.37,Home Improvement,swansea,UK
3749,21/02/2019,DD,VIRGIN MEDIA PYMTS,29.0,,17207.12,Bills,Swansea,UK
3750,19/02/2019,CPT,LNK FABIAN WAY,50.0,,17236.12,Cash,Swansea,UK
3751,19/02/2019,BP,SAVE THE CHANGE,0.66,,17286.12,Savings,Swansea,UK
3752,18/02/2019,DEB,ZARA SWANSEA,49.99,,17286.78,Clothes,Swansea,UK
3753,18/02/2019,DEB,Brontosaurus Vegan,12.66,,17336.77,Dine Out,Swansea,UK
3754,18/02/2019,DEB,AMZN Mktp UK*MI3BZ,11.99,,17349.43,Amazon,Swansea,UK
3755,18/02/2019,DEB,MARKS&SPENCER PLC,8.7,,17361.42,Clothes,,
3756,18/02/2019,DD,O2,17.95,,17370.12,Other Shopping,Swansea,UK
3757,18/02/2019,BP,SAVE THE CHANGE,0.57,,17388.07,Savings,Swansea,UK
3758,15/02/2019,DEB,AMZN Mktp UK*MI5TU,8.43,,17388.64,Amazon,Swansea,UK
3759,15/02/2019,CPT,LNK TESCO FABIAN W,50.0,,17397.07,Cash,Swansea,UK
3760,13/02/2019,BP,SAVE THE CHANGE,0.64,,17447.07,Savings,Swansea,UK
3761,2019-12-02 00:00:00,DEB,AMZN MKTP UK*MI4ED,8.37,,17447.71,Amazon,Swansea,UK
3762,2019-12-02 00:00:00,DEB,AMZN Mktp UK*MI5RP,7.99,,17456.08,Amazon,Swansea,UK
3763,2019-12-02 00:00:00,CPT,LNK UNI - UNIVERSI,50.0,,17464.07,Cash,Swansea,UK
3764,2019-12-02 00:00:00,BP,SAVE THE CHANGE,1.45,,17514.07,Savings,Swansea,UK
3765,2019-11-02 00:00:00,DEB,AMAZON.CO.UK*MI5QA,7.86,,17515.52,Amazon,Swansea,UK
3766,2019-11-02 00:00:00,DEB,Brontosaurus Vegan,23.62,,17523.38,Dine Out,Swansea,UK
3767,2019-11-02 00:00:00,DEB,IQRA SWANSEA LIMIT,20.97,,17547.0,,,
3768,2019-11-02 00:00:00,DEB,MARKS&SPENCER PLC,8.1,,17567.97,Clothes,,
3769,2019-11-02 00:00:00,DEB,POUNDLAND LTD 1414,4.0,,17576.07,Groceries,,
3770,2019-08-02 00:00:00,DD,LV LIFE,37.12,,17580.07,Insurance,Swansea,UK
3771,2019-08-02 00:00:00,BP,SAVE THE CHANGE,0.87,,17617.19,Savings,Swansea,UK
3772,2019-07-02 00:00:00,DEB,POUNDSTRETCHER 270,7.13,,17618.06,Groceries,,
3773,2019-07-02 00:00:00,CPT,LNK TESCO FABIAN W,60.0,,17625.19,Cash,Swansea,UK
3774,2019-07-02 00:00:00,BP,SAVE THE CHANGE,0.85,,17685.19,Savings,Swansea,UK
3775,2019-06-02 00:00:00,DEB,SAINSBURY'S S/MKT,22.15,,17686.04,Groceries,,
3776,2019-06-02 00:00:00,BP,SAVE THE CHANGE,0.61,,17708.19,Savings,Swansea,UK
3777,2019-05-02 00:00:00,DEB,AMZN Mktp UK*MI47S,2.39,,17708.8,Amazon,Swansea,UK
3778,2019-05-02 00:00:00,CPT,LNK FABIAN WAY,50.0,,17711.19,Cash,Swansea,UK
3779,2019-05-02 00:00:00,BP,SAVE THE CHANGE,0.67,,17761.19,Savings,Swansea,UK
3780,2019-04-02 00:00:00,DEP,CLUB LLOYDS WAIVED,,3.0,17761.86,Dine Out,Swansea,UK
3781,2019-04-02 00:00:00,PAY,CLUB LLOYDS FEE,3.0,,17758.86,Bills,Swansea,UK
3782,2019-04-02 00:00:00,DEB,Brontosaurus Vegan,26.73,,17761.86,Supplementary Income,Swansea,UK
3783,2019-04-02 00:00:00,DEB,MARKS&SPENCER PLC,13.6,,17788.59,Clothes,,
3784,2019-04-02 00:00:00,DD,ASSURANT INTER LTD,21.15,,17802.19,Insurance,Swansea,UK
3785,2019-04-02 00:00:00,BP,SAVE THE CHANGE,0.33,,17823.34,Savings,Swansea,UK
3786,2019-01-02 00:00:00,,INTEREST (GROSS),,6.12,17823.67,Interest,Swansea,UK
3787,2019-01-02 00:00:00,DEB,TESCO STORES 4628,2.67,,17817.55,Groceries,,
3788,2019-01-02 00:00:00,DD,PRINCIPALITY BS,957.26,,17820.22,Mortgage,Swansea,UK
3789,2019-01-02 00:00:00,DD,GOOD ENERGY LTD,97.0,,18777.48,Bills,Swansea,UK
3790,2019-01-02 00:00:00,DD,AVIVA LIFE,46.46,,18874.48,Insurance,Swansea,UK
3791,2019-01-02 00:00:00,DD,DWR CYMRU W WATER,23.5,,18920.94,Bills,Swansea,UK
3792,2019-01-02 00:00:00,DD,ZURICH,20.69,,18944.44,Insurance,Swansea,UK
3793,2019-01-02 00:00:00,DD,CC SWANSEA C.TAX,13.81,,18965.13,Bills,Swansea,UK
3794,2019-01-02 00:00:00,SO,ESAVINGS ACCOUNT,300.0,,18978.94,Savings,Swansea,UK
3795,2019-01-02 00:00:00,BP,SAVE THE CHANGE,0.8,,19278.94,Savings,Swansea,UK
3796,31/01/2019,DEB,BIRMINGHAM INT HOT,47.0,,19279.74,Hotels,Birmingham,UK
3797,31/01/2019,DEB,WASABI BIRMINGHAM,12.2,,19326.74,Dine Out,Birmingham,UK
3798,31/01/2019,CPT,LNK TESCO FABIAN W,60.0,,19338.94,Cash,Swansea,UK
3799,31/01/2019,DD,UCU B ACCOUNT,24.26,,19398.94,Others,Swansea,UK
3800,31/01/2019,BP,SAVE THE CHANGE,1.0,,19423.2,Savings,Swansea,UK
3801,31/01/2019,BGC,SWANSEA UNI - PAY,,3251.36,19424.2,Paycheck,Swansea,UK
3802,30/01/2019,DEB,TFW RAIL SERVICES,67.4,,16172.84,Travel,,
3803,30/01/2019,DEB,SHREWSBURY STARBUC,8.6,,16240.24,Dine Out,Shrewsbury,UK
3804,30/01/2019,DEB,THE BIKE HUB,5.0,,16248.84,Other Shopping,,
3805,29/01/2019,CPT,LOYD LOYD 802 OXFO,60.0,,16253.84,Cash,Swansea,UK
3806,29/01/2019,BP,SAVE THE CHANGE,0.8,,16313.84,Savings,Swansea,UK
3807,28/01/2019,DEB,MARKS&SPENCER PLC,10.2,,16314.64,Clothes,,
3808,28/01/2019,BP,SAVE THE CHANGE,0.1,,16324.84,Savings,Swansea,UK
3809,25/01/2019,DEB,SAINSBURY'S S/MKT,12.9,,16324.94,Groceries,,
3810,25/01/2019,CPT,LNK TESCO FABIAN W,60.0,,16337.84,Cash,Swansea,UK
3811,25/01/2019,BP,SAVE THE CHANGE,0.01,,16397.84,Savings,Swansea,UK
3812,24/01/2019,DEB,Audible.co.uk,7.99,,16397.85,Entertainment,Swansea,UK
3813,24/01/2019,BP,SAVE THE CHANGE,0.5,,16405.84,Savings,Swansea,UK
3814,23/01/2019,DEB,HOLIDAY INNS,96.0,,16406.34,Hotels,,
3815,23/01/2019,DEB,HOLIDAY INNS,3.5,,16502.34,Hotels,,
3816,23/01/2019,BP,SAVE THE CHANGE,0.9,,16505.84,Savings,Swansea,UK
3817,22/01/2019,DEB,LUL TICKET MACHINE,13.1,,16506.74,Travel,London,UK
3818,22/01/2019,DD,CORGI HOMEPLAN,14.75,,16519.84,Home Improvement,swansea,UK
3819,22/01/2019,BP,SAVE THE CHANGE,2.36,,16534.59,Savings,Swansea,UK
3820,21/01/2019,DEB,PIZZA EXPRESS,27.45,,16536.95,Dine Out,,
3821,21/01/2019,DEB,Brontosaurus Vegan,20.89,,16564.4,Dine Out,Swansea,UK
3822,21/01/2019,DEB,MARKS&SPENCER PLC,13.2,,16585.29,Clothes,,
3823,21/01/2019,DEB,COFFEE#1 SWANSEA,6.6,,16598.49,Dine Out,Swansea,UK
3824,21/01/2019,DEB,TESCO STORES 4628,6.5,,16605.09,Groceries,,
3825,21/01/2019,DD,VIRGIN MEDIA PYMTS,29.0,,16611.59,Bills,Swansea,UK
3826,21/01/2019,CPT,LNK BEST ONE,40.0,,16640.59,Cash,,
3827,18/01/2019,CPT,LNK TESCO FABIAN W,60.0,,16680.59,Cash,Swansea,UK
3828,18/01/2019,BP,SAVE THE CHANGE,0.3,,16740.59,Savings,Swansea,UK
3829,17/01/2019,DEB,GWR WEBSALES,116.7,,16740.89,Travel,,
3830,16/01/2019,DD,O2,16.78,,16857.59,Other Shopping,Swansea,UK
3831,16/01/2019,BP,SAVE THE CHANGE,0.33,,16874.37,Savings,Swansea,UK
3832,15/01/2019,CPT,LNK TESCO FABIAN W,60.0,,16874.7,Cash,Swansea,UK
3833,15/01/2019,DEB,SAINSBURYS S/MKTS,30.0,,16934.7,Groceries,,
3834,15/01/2019,DEB,NON-GBP PURCH FEE,0.5,,16964.7,Others,Swansea,UK
3835,15/01/2019,DEB,NON-GBP TRANS FEE,0.58,,16965.2,Others,Swansea,UK
3836,15/01/2019,DEB,RMV CONTACT CENTER,19.67,,16965.78,Others,Swansea,UK
3837,15/01/2019,BP,SAVE THE CHANGE,0.39,,16985.45,Savings,Swansea,UK
3838,14/01/2019,DEB,Brontosaurus Vegan,23.61,,16985.84,Dine Out,Swansea,UK
3839,14/01/2019,BP,REMUS MANAGEMENTV2,126.69,,17009.45,Clothes,,
3840,2019-11-01 00:00:00,CPT,LNK TESCO FABIAN W,60.0,,17136.14,Cash,Swansea,UK
3841,2019-11-01 00:00:00,DD,LV LIFE,37.12,,17196.14,Insurance,Swansea,UK
3842,2019-08-01 00:00:00,BP,SAVE THE CHANGE,0.79,,17233.26,Savings,Swansea,UK
3843,2019-07-01 00:00:00,DEB,Brontosaurus Vegan,21.41,,17234.05,Dine Out,Swansea,UK
3844,2019-07-01 00:00:00,DEB,NON-GBP PURCH FEE,0.5,,17255.46,Others,Swansea,UK
3845,2019-07-01 00:00:00,DEB,NON-GBP TRANS FEE,4.18,,17255.96,Others,Swansea,UK
3846,2019-07-01 00:00:00,DEB,ART VILLA NAUTILUS,140.0,,17260.14,Hotels,Santa Cruz de Tenerife,Spain
3847,2019-07-01 00:00:00,DEB,GWR BRISTOL TM SST,28.8,,17400.14,Travel,Bristol,
3848,2019-07-01 00:00:00,CPT,LOYD LOYD 802 OXFO,60.0,,17428.94,Cash,Swansea,UK
3849,2019-03-01 00:00:00,DEP,CLUB LLOYDS WAIVED,,3.0,17488.94,Insurance,Swansea,UK
3850,2019-03-01 00:00:00,PAY,CLUB LLOYDS FEE,3.0,,17485.94,Bills,Swansea,UK
3851,2019-03-01 00:00:00,DD,ASSURANT INTER LTD,21.15,,17488.94,Supplementary Income,Swansea,UK
3852,2019-03-01 00:00:00,DD,ZURICH,20.69,,17510.09,Insurance,Swansea,UK
3853,2019-02-01 00:00:00,,INTEREST (GROSS),,6.12,17530.78,Interest,Swansea,UK
3854,2019-02-01 00:00:00,DD,PRINCIPALITY BS,957.26,,17524.66,Mortgage,Swansea,UK
3855,2019-02-01 00:00:00,DD,GOOD ENERGY LTD,97.0,,18481.92,Bills,Swansea,UK
3856,2019-02-01 00:00:00,DD,AVIVA LIFE,46.46,,18578.92,Insurance,Swansea,UK
3857,2019-02-01 00:00:00,DD,DWR CYMRU W WATER,23.5,,18625.38,Bills,Swansea,UK
3858,2019-02-01 00:00:00,SO,ESAVINGS ACCOUNT,300.0,,18648.88,Savings,Swansea,UK
3859,31/12/2018,DD,UCU B ACCOUNT,24.26,,18948.88,Others,Swansea,UK
3860,31/12/2018,BP,SAVE THE CHANGE,0.6,,18973.14,Savings,Swansea,UK
3861,31/12/2018,BGC,SWANSEA UNI - PAY,,3251.36,18973.74,Paycheck,Swansea,UK
3862,28/12/2018,DEB,TFW RAIL SERVICES,8.4,,15722.38,Travel,,
3863,28/12/2018,BP,SAVE THE CHANGE,1.79,,15730.78,Savings,Swansea,UK
3864,27/12/2018,DEB,NON-GBP PURCH FEE,0.5,,15732.57,Others,Swansea,UK
3865,27/12/2018,DEB,NON-GBP TRANS FEE,1.34,,15733.07,Others,Swansea,UK
3866,27/12/2018,DEB,Hotel on Booking.c,45.14,,15734.41,Hotels,,
3867,27/12/2018,DEB,FRANCESCO LEONE,147.73,,15779.55,Services,Swansea,UK
3868,27/12/2018,DEB,NON-GBP PURCH FEE,0.5,,15927.28,Others,Swansea,UK
3869,27/12/2018,DEB,NON-GBP TRANS FEE,0.39,,15927.78,Others,Swansea,UK
3870,27/12/2018,DEB,COVIRAN LOS ABRIGO,13.34,,15928.17,Groceries,Santa Cruz de Tenerife,Spain
3871,27/12/2018,BP,SAVE THE CHANGE,1.77,,15941.51,Savings,Swansea,UK
3872,24/12/2018,DEB,AMZN Mktp UK*M2882,2.71,,15943.28,Amazon,Swansea,UK
3873,24/12/2018,DEB,Audible.co.uk,7.99,,15945.99,Entertainment,Swansea,UK
3874,24/12/2018,DEB,Brontosaurus Vegan,12.98,,15953.98,Dine Out,Swansea,UK
3875,24/12/2018,DEB,POST OFFICE SELF S,24.35,,15966.96,Others,Swansea,UK
3876,24/12/2018,DEB,SAINSBURY'S S/MKT,20.5,,15991.31,Groceries,,
3877,24/12/2018,DEB,MARKS&SPENCER PLC,2.7,,16011.81,Clothes,,
3878,24/12/2018,DD,CORGI HOMEPLAN,14.75,,16014.51,Home Improvement,Swansea,UK
3879,24/12/2018,BGC,SWANSEA UNIVERSITY,,516.6,16029.26,Supplementary Income,Swansea,UK
3880,24/12/2018,CPT,LNK M&S SWANSEA,40.0,,15512.66,Cash,Swansea,UK
3881,21/12/2018,CPT,P.O. 37 THE QUADAN,99.01,,15552.66,Entertainment,Swansea,UK
3882,21/12/2018,DD,VIRGIN MEDIA PYMTS,29.0,,15651.67,Bills,Nottingham,UK
3883,20/12/2018,BP,SAVE THE CHANGE,0.2,,15680.67,Savings,Swansea,UK
3884,19/12/2018,DEB,SAINSBURY'S S/MKT,24.8,,15680.87,Groceries,,
3885,19/12/2018,CPT,LNK TESCO FABIAN W,60.0,,15705.67,Cash,Swansea,UK
3886,19/12/2018,BP,SAVE THE CHANGE,0.09,,15765.67,Savings,Swansea,UK
3887,18/12/2018,DEB,Amazon.co.uk*M23Q2,5.91,,15765.76,Amazon,Swansea,UK
3888,18/12/2018,BP,SAVE THE CHANGE,1.26,,15771.67,Savings,Swansea,UK
3889,17/12/2018,DEB,TUI,259.0,,15772.93,Travel,,
3890,17/12/2018,DEB,TUI,84.0,,16031.93,Travel,,
3891,17/12/2018,DEB,DEBENHAMS,72.0,,16115.93,Other Shopping,,
3892,17/12/2018,DEB,HOSTEL WORLD,22.24,,16187.93,Hotels,,
3893,17/12/2018,DEB,TFW RAIL SERVICES,11.5,,16210.17,Travel,,
3894,17/12/2018,DD,O2,18.5,,16221.67,Other Shopping,Swansea,UK
3895,17/12/2018,CPT,LNK ARRIVA TRAINS,50.0,,16240.17,Cash,,
3896,14/12/2018,DEB,TESCO STORES 4628,11.0,,16290.17,Groceries,,
3897,14/12/2018,BGC,SWANSEA UNIVERSITY,,939.47,16301.17,Supplementary Income,Swansea,UK
3898,13/12/2018,DEB,EUROPEAN MOVING,230.0,,15361.7,Others,Swansea,UK
3899,13/12/2018,CPT,LNK TESCO FABIAN W,60.0,,15591.7,Cash,Swansea,UK
3900,2018-11-12 00:00:00,BP,SAVE THE CHANGE,0.51,,15651.7,Savings,Swansea,UK
3901,2018-10-12 00:00:00,CPT,LNK TESCO FABIAN W,40.0,,15652.21,Cash,Swansea,UK
3902,2018-10-12 00:00:00,DEB,MOUNTAIN WAREHOUSE,49.99,,15692.21,Other Shopping,Leicester,UK
3903,2018-10-12 00:00:00,DEB,TFW RAIL SERVICES,11.5,,15742.2,Travel,,
3904,2018-10-12 00:00:00,DD,LV LIFE,37.12,,15753.7,Insurance,Swansea,UK
3905,2018-10-12 00:00:00,CPT,LNK CARDIFF 1,40.0,,15790.82,Cash,Cardiff,UK
3906,2018-06-12 00:00:00,CPT,LNK TESCO FABIAN W,60.0,,15830.82,Cash,Swansea,UK
3907,2018-06-12 00:00:00,BP,SAVE THE CHANGE,1.11,,15890.82,Savings,Swansea,UK
3908,2018-05-12 00:00:00,DEB,EUROPEAN MOVING,511.7,,15891.93,Others,Swansea,UK
3909,2018-05-12 00:00:00,DEB,AMAZON.CO.UK*M005N,4.19,,16403.63,Amazon,Swansea,UK
3910,2018-05-12 00:00:00,BP,SAVE THE CHANGE,0.04,,16407.82,Savings,Swansea,UK
3911,2018-04-12 00:00:00,DEP,CLUB LLOYDS WAIVED,,3.0,16407.86,Amazon,Swansea,UK
3912,2018-04-12 00:00:00,PAY,CLUB LLOYDS FEE,3.0,,16404.86,Bills,Swansea,UK
3913,2018-04-12 00:00:00,DEB,AMZN MKTP UK*M04GF,3.96,,16407.86,Supplementary Income,Swansea,UK
3914,2018-04-12 00:00:00,CPT,LNK TESCO FABIAN W,40.0,,16411.82,Cash,Swansea,UK
3915,2018-04-12 00:00:00,BP,SAVE THE CHANGE,0.9,,16451.82,Savings,Swansea,UK
3916,2018-03-12 00:00:00,,INTEREST (GROSS),,6.53,16452.72,Interest,Swansea,UK
3917,2018-03-12 00:00:00,DEB,AMAZON.CO.UK*M050B,22.6,,16446.19,Amazon,Swansea,UK
3918,2018-03-12 00:00:00,DEB,SAINSBURYS S/MKTS,22.5,,16468.79,Groceries,,
3919,2018-03-12 00:00:00,DD,PRINCIPALITY BS,957.26,,16491.29,Mortgage,Swansea,UK
3920,2018-03-12 00:00:00,DD,CC SWANSEA C.TAX,184.0,,17448.55,Bills,Swansea,UK
3921,2018-03-12 00:00:00,DD,GOOD ENERGY LTD,97.0,,17632.55,Bills,Swansea,UK
3922,2018-03-12 00:00:00,DD,AVIVA LIFE,46.46,,17729.55,Insurance,Swansea,UK
3923,2018-03-12 00:00:00,DD,DWR CYMRU W WATER,23.5,,17776.01,Bills,Swansea,UK
3924,2018-03-12 00:00:00,DD,ASSURANT INTER LTD,21.15,,17799.51,Insurance,Swansea,UK
3925,2018-03-12 00:00:00,DD,ZURICH,20.69,,17820.66,Insurance,Swansea,UK
3926,2018-03-12 00:00:00,SO,ESAVINGS ACCOUNT,300.0,,17841.35,Savings,Swansea,UK
3927,2018-03-12 00:00:00,BP,SAVE THE CHANGE,0.55,,18141.35,Savings,Swansea,UK
3928,2018-03-12 00:00:00,CPT,LOYD LOYD 802 OXFO,50.0,,18141.9,Cash,Swansea,UK
3929,30/11/2018,DEB,LAS IGUNAS,36.45,,18191.9,Dine Out,,
3930,30/11/2018,DD,UCU B ACCOUNT,24.26,,18228.35,Others,Swansea,UK
3931,30/11/2018,BGC,SWANSEA UNI - PAY,,3251.36,18252.61,Paycheck,Swansea,UK
3932,29/11/2018,CPT,LNK PO THE CITYOFS,50.0,,15001.25,Cash,,
3933,27/11/2018,BP,SAVE THE CHANGE,1.35,,15051.25,Savings,Swansea,UK
3934,26/11/2018,DEB,EASYJET   EVXNX8,32.0,,15052.6,Travel,,
3935,26/11/2018,DEB,WILKO RETAIL LIMIT,23.0,,15084.6,Other Shopping,,
3936,26/11/2018,DEB,AMAZON.CO.UK*M83AN,11.85,,15107.6,Amazon,Swansea,UK
3937,26/11/2018,DEB,AMZN MKTP UK*M849V,49.98,,15119.45,Amazon,Swansea,UK
3938,26/11/2018,DEB,Brontosaurus Vegan,33.6,,15169.43,Dine Out,Swansea,UK
3939,26/11/2018,DEB,AMAZON.CO.UK*M83UY,3.23,,15203.03,Amazon,Swansea,UK
3940,26/11/2018,DEB,Audible.co.uk,7.99,,15206.26,Entertainment,Swansea,UK
3941,26/11/2018,CPT,LNK UNI - UNIVERSI,80.0,,15214.25,Cash,Swansea,UK
3942,23/11/2018,CPT,LNK TESCO FABIAN W,40.0,,15294.25,Cash,Swansea,UK
3943,22/11/2018,DD,CORGI HOMEPLAN,14.75,,15334.25,Home Improvement,Swansea,UK
3944,22/11/2018,BP,SAVE THE CHANGE,1.06,,15349.0,Savings,Swansea,UK
3945,21/11/2018,DEB,AMZN Mktp UK*M85HN,8.88,,15350.06,Amazon,Swansea,UK
3946,21/11/2018,DEB,Amazon.co.uk*M88N5,4.33,,15358.94,Amazon,Swansea,UK
3947,21/11/2018,CPT,LNK TESCO FABIAN W,40.0,,15363.27,Cash,Swansea,UK
3948,21/11/2018,DD,VIRGIN MEDIA PYMTS,29.0,,15403.27,Bills,Nottingham,UK
3949,21/11/2018,DEB,NON-GBP PURCH FEE,0.5,,15432.27,Others,Swansea,UK
3950,21/11/2018,DEB,NON-GBP TRANS FEE,1.06,,15432.77,Others,Swansea,UK
3951,21/11/2018,DEB,KLM*REF UGUA8R OPT,35.73,,15433.83,Travel,,
3952,21/11/2018,BP,SAVE THE CHANGE,0.35,,15469.56,Savings,Swansea,UK
3953,20/11/2018,DEB,NON-GBP PURCH FEE,0.5,,15469.91,Others,Swansea,UK
3954,20/11/2018,DEB,NON-GBP TRANS FEE,6.75,,15470.41,Others,Swansea,UK
3955,20/11/2018,DEB,SCHLOSS DAGSTUHL -,225.81,,15477.16,Entertainment,,
3956,20/11/2018,DEB,NON-GBP PURCH FEE,0.5,,15702.97,Others,Swansea,UK
3957,20/11/2018,DEB,NON-GBP TRANS FEE,2.47,,15703.47,Others,Swansea,UK
3958,20/11/2018,DEB,SCHLOSS DAGSTUHL -,82.84,,15705.94,Entertainment,,
3959,20/11/2018,BP,SAVE THE CHANGE,0.6,,15788.78,Savings,Swansea,UK
3960,19/11/2018,DEB,Brontosaurus Vegan,24.41,,15789.38,Dine Out,Swansea,UK
3961,19/11/2018,DEB,CANDLES & CO,21.99,,15813.79,Other Shopping,,
3962,19/11/2018,CPT,LNK M&S SWANSEA,80.0,,15835.78,Cash,Swansea,UK
3963,16/11/2018,DD,O2,19.45,,15915.78,Other Shopping,Swansea,UK
3964,15/11/2018,BP,SAVE THE CHANGE,0.03,,15935.23,Savings,Swansea,UK
3965,14/11/2018,DEB,NON-GBP PURCH FEE,0.5,,15935.26,Others,Swansea,UK
3966,14/11/2018,DEB,NON-GBP TRANS FEE,1.76,,15935.76,Others,Swansea,UK
3967,14/11/2018,DEB,DB AUTOMATEN,58.97,,15937.52,Travel,,
3968,14/11/2018,BP,SAVE THE CHANGE,0.17,,15996.49,Savings,Swansea,UK
3969,13/11/2018,DEB,KLM UNITEDKI074822,34.83,,15996.66,Travel,,
3970,13/11/2018,BP,SAVE THE CHANGE,0.8,,16031.49,Savings,Swansea,UK
3971,2018-12-11 00:00:00,DEB,ARRIVA TRAINS WALE,38.2,,16032.29,Travel,,
3972,2018-12-11 00:00:00,CPT,LNK ARRIVA TRAINS,40.0,,16070.49,Cash,,
3973,2018-12-11 00:00:00,CPT,LNK M&S SWANSEA,60.0,,16110.49,Cash,Swansea,UK
3974,2018-09-11 00:00:00,DD,LV LIFE,37.12,,16170.49,Insurance,Swansea,UK
3975,2018-07-11 00:00:00,CPT,LNK TESCO FABIAN W,60.0,,16207.61,Cash,Swansea,UK
3976,2018-05-11 00:00:00,DD,ASSURANT INTER LTD,21.15,,16267.61,Insurance,Swansea,UK
3977,2018-02-11 00:00:00,DEP,CLUB LLOYDS WAIVED,,3.0,16288.76,Supplementary Income,Swansea,UK
3978,2018-02-11 00:00:00,PAY,CLUB LLOYDS FEE,3.0,,16285.76,Bills,Swansea,UK
3979,2018-02-11 00:00:00,BGC,SWANSEA UNIVERSITY,,105.6,16288.76,Supplementary Income,Swansea,UK
3980,2018-01-11 00:00:00,,INTEREST (GROSS),,6.33,16183.16,Interest,Swansea,UK
3981,2018-01-11 00:00:00,DD,PRINCIPALITY BS,957.26,,16176.83,Mortgage,Swansea,UK
3982,2018-01-11 00:00:00,DD,CC SWANSEA C.TAX,184.0,,17134.09,Bills,Swansea,UK
3983,2018-01-11 00:00:00,DD,GOOD ENERGY LTD,97.0,,17318.09,Bills,Swansea,UK
3984,2018-01-11 00:00:00,DD,AVIVA LIFE,46.46,,17415.09,Insurance,Swansea,UK
3985,2018-01-11 00:00:00,DD,DWR CYMRU W WATER,23.5,,17461.55,Bills,Swansea,UK
3986,2018-01-11 00:00:00,DD,ZURICH,20.69,,17485.05,Insurance,Swansea,UK
3987,2018-01-11 00:00:00,SO,ESAVINGS ACCOUNT,300.0,,17505.74,Savings,Swansea,UK
3988,31/10/2018,DD,UCU B ACCOUNT,24.26,,17805.74,Others,Swansea,UK
3989,31/10/2018,BP,SAVE THE CHANGE,0.87,,17830.0,Savings,Swansea,UK
3990,31/10/2018,BGC,SWANSEA UNI - PAY,,3251.36,17830.87,Paycheck,Swansea,UK
3991,30/10/2018,DEB,SWANSEA UNI - CATE,4.5,,14579.51,Dine Out,Swansea,UK
3992,30/10/2018,CHQ,LOYD 802 OXFORD ST,,1383.0,14584.01,Supplementary Income,Swansea,UK
3993,30/10/2018,DEB,NON-GBP PURCH FEE,0.5,,13201.01,Others,Swansea,UK
3994,30/10/2018,DEB,NON-GBP TRANS FEE,22.14,,13201.51,Others,Swansea,UK
3995,30/10/2018,DEB,ESTREL FRONT OFFIC,740.63,,13223.65,Travel,Berlin,Germany
3996,30/10/2018,BP,SAVE THE CHANGE,1.16,,13964.28,Savings,Swansea,UK
3997,29/10/2018,DEB,Brontosaurus Vegan,31.34,,13965.44,Dine Out,Swansea,UK
3998,29/10/2018,DEB,ARRIVA TRAINS WALE,11.5,,13996.78,Travel,,
3999,29/10/2018,CPT,LNK TESCO FABIAN W,40.0,,14008.28,Cash,Swansea,UK
4000,29/10/2018,CPT,LOYD LOYD 802 OXFO,50.0,,14048.28,Cash,Swansea,UK
4001,25/10/2018,BP,SAVE THE CHANGE,0.01,,14098.28,Savings,Swansea,UK
4002,24/10/2018,DEB,Audible.co.uk,7.99,,14098.29,Entertainment,Swansea,UK
4003,22/10/2018,DD,VIRGIN MEDIA PYMTS,22.4,,14106.28,Bills,Nottingham,UK
4004,22/10/2018,DD,CORGI HOMEPLAN,14.75,,14128.68,Home Improvement,Swansea,UK
4005,22/10/2018,BP,SAVE THE CHANGE,1.29,,14143.43,Savings,Swansea,UK
4006,19/10/2018,DEB,TESCO STORES 4628,12.25,,14144.72,Groceries,,
4007,19/10/2018,DEB,AMZN Mktp UK,3.46,,14156.97,Amazon,Swansea,UK
4008,19/10/2018,BP,SAVE THE CHANGE,0.35,,14160.43,Savings,Swansea,UK
4009,18/10/2018,DEB,AMZN Mktp UK,69.99,,14160.78,Amazon,Swansea,UK
4010,18/10/2018,DEB,AMAZON.CO.UK AMAZO,11.77,,14230.77,Amazon,Swansea,UK
4011,18/10/2018,DEB,Amazon.co.uk,6.89,,14242.54,Amazon,Swansea,UK
4012,18/10/2018,CPT,LNK TESCO FABIAN W,50.0,,14249.43,Cash,Swansea,UK
4013,18/10/2018,BP,SAVE THE CHANGE,0.77,,14299.43,Savings,Swansea,UK
4014,17/10/2018,DEB,NON-STG PURCH FEE,0.5,,14300.2,Others,Swansea,UK
4015,17/10/2018,DEB,NON-STG TRANS FEE,1.14,,14300.7,Others,Swansea,UK
4016,17/10/2018,DEB,WPY*PayIt2com Ragh,38.23,,14301.84,Investment,Nottingham,UK
4017,16/10/2018,CPT,LNK TESCO FABIAN W,50.0,,14340.07,Cash,Swansea,UK
4018,16/10/2018,DD,O2,18.5,,14390.07,Other Shopping,Swansea,UK
4019,16/10/2018,BP,SAVE THE CHANGE,0.01,,14408.57,Savings,Swansea,UK
4020,15/10/2018,DEB,AMZN Mktp UK,14.99,,14408.58,Amazon,Swansea,UK
4021,2018-11-10 00:00:00,BP,SAVE THE CHANGE,0.52,,14423.57,Savings,Swansea,UK
4022,2018-10-10 00:00:00,DEB,EASYJET   EVXNX8,359.9,,14424.09,Travel,,
4023,2018-10-10 00:00:00,DEB,AMZN MKTP UK AMAZO,7.99,,14783.99,Amazon,Swansea,UK
4024,2018-10-10 00:00:00,DEB,AMZN MKTP UK AMAZO,7.59,,14791.98,Amazon,Swansea,UK
4025,2018-10-10 00:00:00,TFR,F/FLOW KATHLEEN M,,721.25,14799.57,Supplementary Income,Swansea,UK
4026,2018-09-10 00:00:00,FPI,MARIANA MILLS,,180.0,14078.32,Supplementary Income,Swansea,UK
4027,2018-09-10 00:00:00,BP,SAVE THE CHANGE,0.49,,13898.32,Savings,Swansea,UK
4028,2018-08-10 00:00:00,DEB,AMZN Mktp UK,5.51,,13898.81,Amazon,Swansea,UK
4029,2018-08-10 00:00:00,CPT,LNK UNI - UNIVERSI,100.0,,13904.32,Cash,Swansea,UK
4030,2018-08-10 00:00:00,DD,LV LIFE,37.12,,14004.32,Insurance,Swansea,UK
4031,2018-08-10 00:00:00,CPT,LNK M&S SWANSEA,100.0,,14041.44,Cash,Swansea,UK
4032,2018-05-10 00:00:00,CPT,LNK UNI - UNIVERSI,50.0,,14141.44,Cash,Swansea,UK
4033,2018-05-10 00:00:00,BP,SAVE THE CHANGE,0.35,,14191.44,Savings,Swansea,UK
4034,2018-04-10 00:00:00,DEB,DELIVEROO.CO.UK,24.65,,14191.79,Dine Out,,
4035,2018-03-10 00:00:00,DD,ASSURANT INTER LTD,21.15,,14216.44,Insurance,Swansea,UK
4036,2018-03-10 00:00:00,BP,SAVE THE CHANGE,0.01,,14237.59,Savings,Swansea,UK
4037,2018-02-10 00:00:00,DEP,CLUB LLOYDS WAIVED,,3.0,14237.6,Amazon,Swansea,UK
4038,2018-02-10 00:00:00,PAY,CLUB LLOYDS FEE,3.0,,14234.6,Bills,Swansea,UK
4039,2018-02-10 00:00:00,DEB,Amazon.co.uk,14.99,,14237.6,Supplementary Income,Swansea,UK
4040,2018-02-10 00:00:00,BP,SAVE THE CHANGE,3.25,,14252.59,Savings,Swansea,UK
4041,2018-01-10 00:00:00,,INTEREST (GROSS),,5.71,14255.84,Interest,Swansea,UK
4042,2018-01-10 00:00:00,DEB,AMZN Mktp UK,23.88,,14250.13,Amazon,Swansea,UK
4043,2018-01-10 00:00:00,DEB,AMZN Mktp UK,4.49,,14274.01,Amazon,Swansea,UK
4044,2018-01-10 00:00:00,DEB,Brontosaurus Vegan,37.29,,14278.5,Dine Out,Swansea,UK
4045,2018-01-10 00:00:00,DEB,GOOGLE *YouTube Vi,3.49,,14315.79,,,
4046,2018-01-10 00:00:00,DEB,ARRIVA TRAINS WALE,75.1,,14319.28,Travel,,
4047,2018-01-10 00:00:00,DEB,WASABI BIRMINGHAM,30.5,,14394.38,Dine Out,Birmingham,UK
4048,2018-01-10 00:00:00,DEB,easyHotel Birmingh,10.0,,14424.88,Hotels,Birmingham,UK
4049,2018-01-10 00:00:00,DD,PRINCIPALITY BS,957.26,,14434.88,Mortgage,Swansea,UK
4050,2018-01-10 00:00:00,DD,CC SWANSEA C.TAX,184.0,,15392.14,Bills,Swansea,UK
4051,2018-01-10 00:00:00,DD,GOOD ENERGY LTD,97.0,,15576.14,Bills,Swansea,UK
4052,2018-01-10 00:00:00,DD,AVIVA LIFE,46.46,,15673.14,Insurance,Swansea,UK
4053,2018-01-10 00:00:00,DD,DWR CYMRU W WATER,23.5,,15719.6,Bills,Swansea,UK
4054,2018-01-10 00:00:00,DD,ZURICH,20.69,,15743.1,Insurance,Swansea,UK
4055,2018-01-10 00:00:00,SO,ESAVINGS ACCOUNT,300.0,,15763.79,Savings,Swansea,UK
4056,2018-01-10 00:00:00,CPT,LNK MORRISONS SWAN,50.0,,16063.79,Cash,Swansea,UK
4057,28/09/2018,DD,UCU B ACCOUNT,24.26,,16113.79,Others,Swansea,UK
4058,28/09/2018,BGC,SWANSEA UNI - PAY,,3250.96,16138.05,Paycheck,Swansea,UK
4059,26/09/2018,CPT,LNK UNI - UNIVERSI,50.0,,12887.09,Cash,Swansea,UK
4060,25/09/2018,BP,SAVE THE CHANGE,0.95,,12937.09,Savings,Swansea,UK
4061,24/09/2018,DEB,Audible.co.uk,7.99,,12938.04,Entertainment,Swansea,UK
4062,24/09/2018,DEB,Brontosaurus Vegan,43.06,,12946.03,Dine Out,Swansea,UK
4063,24/09/2018,CPT,LNK MORRISONS SWAN,200.0,,12989.09,Cash,Swansea,UK
4064,21/09/2018,DD,VIRGIN MEDIA PYMTS,40.0,,13189.09,Bills,Nottingham,UK
4065,21/09/2018,BP,SAVE THE CHANGE,0.6,,13229.09,Savings,Swansea,UK
4066,21/09/2018,BGC,SWANSEA UNIVERSITY,,170.74,13229.69,Supplementary Income,Swansea,UK
4067,20/09/2018,DEB,DELIVEROO.CO.UK,24.4,,13058.95,Dine Out,,
4068,20/09/2018,BP,SAVE THE CHANGE,0.01,,13083.35,Savings,Swansea,UK
4069,19/09/2018,DEB,Amazon.co.uk,77.0,,13083.36,Amazon,Swansea,UK
4070,19/09/2018,DEB,easyHotel Birmingh,42.99,,13160.36,Hotels,Birmingham,UK
4071,19/09/2018,CPT,LNK UNI - UNIVERSI,50.0,,13203.35,Cash,Swansea,UK
4072,18/09/2018,BP,SAVE THE CHANGE,0.04,,13253.35,Savings,Swansea,UK
4073,17/09/2018,DEB,AMZN MKTP UK AMAZO,33.96,,13253.39,Amazon,Swansea,UK
4074,17/09/2018,DD,O2,17.95,,13287.35,Other Shopping,Swansea,UK
4075,17/09/2018,BP,SAVE THE CHANGE,0.37,,13305.3,Savings,Swansea,UK
4076,14/09/2018,DEB,AMZN Mktp UK,2.63,,13305.67,Amazon,Swansea,UK
4077,14/09/2018,BP,SAVE THE CHANGE,0.6,,13308.3,Savings,Swansea,UK
4078,13/09/2018,DEB,DELIVEROO.CO.UK,24.4,,13308.9,Dine Out,,
4079,13/09/2018,BP,SAVE THE CHANGE,0.25,,13333.3,Savings,Swansea,UK
4080,2018-12-09 00:00:00,DEB,AMZN Mktp UK,2.75,,13333.55,Amazon,Swansea,UK
4081,2018-11-09 00:00:00,BP,SAVE THE CHANGE,2.36,,13336.3,Savings,Swansea,UK
4082,2018-10-09 00:00:00,DEB,SQ *FLOOR & DECOR,341.05,,13338.66,Home Improvement,Swansea,UK
4083,2018-10-09 00:00:00,DEB,Brontosaurus Vegan,21.51,,13679.71,Dine Out,Swansea,UK
4084,2018-10-09 00:00:00,DEB,MARKS&SPENCER PLC,11.4,,13701.22,Clothes,,
4085,2018-10-09 00:00:00,DEB,AMZN Mktp UK,8.68,,13712.62,Amazon,Swansea,UK
4086,2018-10-09 00:00:00,DD,LV LIFE,37.12,,13721.3,Insurance,Swansea,UK
4087,2018-07-09 00:00:00,BP,SAVE THE CHANGE,0.51,,13758.42,Savings,Swansea,UK
4088,2018-06-09 00:00:00,DEB,Amazon.co.uk,35.49,,13758.93,Amazon,Swansea,UK
4089,2018-05-09 00:00:00,DD,ASSURANT INTER LTD,21.3,,13794.42,Insurance,Swansea,UK
4090,2018-05-09 00:00:00,BP,SAVE THE CHANGE,0.75,,13815.72,Savings,Swansea,UK
4091,2018-04-09 00:00:00,DEP,CLUB LLOYDS WAIVED,,3.0,13816.47,Amazon,Swansea,UK
4092,2018-04-09 00:00:00,PAY,CLUB LLOYDS FEE,3.0,,13813.47,Bills,Swansea,UK
4093,2018-04-09 00:00:00,DEB,AMZN Mktp UK,5.25,,13816.47,Supplementary Income,Swansea,UK
4094,2018-04-09 00:00:00,BP,SAVE THE CHANGE,1.02,,13821.72,Savings,Swansea,UK
4095,2018-04-09 00:00:00,BGC,IRG ADVISORS LLP,,345.8,13822.74,Supplementary Income,Swansea,UK
4096,2018-04-09 00:00:00,BGC,IRG ADVISORS LLP,,116.4,13476.94,Supplementary Income,Swansea,UK
4097,2018-03-09 00:00:00,,INTEREST (GROSS),,6.74,13360.54,Interest,Swansea,UK
4098,2018-03-09 00:00:00,DEB,Brontosaurus Vegan,23.53,,13353.8,Dine Out,Swansea,UK
4099,2018-03-09 00:00:00,DEB,PAYPAL *VIMEO INC,3.45,,13377.33,Services,Swansea,UK
4100,2018-03-09 00:00:00,DD,PRINCIPALITY BS,957.26,,13380.78,Mortgage,Swansea,UK
4101,2018-03-09 00:00:00,DD,CC SWANSEA C.TAX,184.0,,14338.04,Bills,Swansea,UK
4102,2018-03-09 00:00:00,DD,GOOD ENERGY LTD,97.0,,14522.04,Bills,Swansea,UK
4103,2018-03-09 00:00:00,DD,AVIVA LIFE,46.46,,14619.04,Insurance,Swansea,UK
4104,2018-03-09 00:00:00,DD,DWR CYMRU W WATER,23.5,,14665.5,Bills,Swansea,UK
4105,2018-03-09 00:00:00,DD,ZURICH,19.36,,14689.0,Insurance,Swansea,UK
4106,2018-03-09 00:00:00,SO,ESAVINGS ACCOUNT,300.0,,14708.36,Savings,Swansea,UK
4107,2018-03-09 00:00:00,BP,SAVE THE CHANGE,0.01,,15008.36,Savings,Swansea,UK
4108,2018-03-09 00:00:00,FPO,P M GREY,1360.0,,15008.37,Services,Swansea,UK
4109,31/08/2018,DEB,AMZN Mktp UK,33.99,,16368.37,Amazon,Swansea,UK
4110,31/08/2018,CPT,LNK UNI - UNIVERSI,40.0,,16402.36,Cash,Swansea,UK
4111,31/08/2018,DD,UCU B ACCOUNT,23.11,,16442.36,Others,Swansea,UK
4112,31/08/2018,BGC,SWANSEA UNI - PAY,,3251.36,16465.47,Paycheck,Swansea,UK
4113,30/08/2018,CPT,LNK UNI - UNIVERSI,50.0,,13214.11,Cash,Swansea,UK
4114,30/08/2018,BP,SAVE THE CHANGE,0.9,,13264.11,Savings,Swansea,UK
4115,29/08/2018,DEB,AMZN Mktp UK,7.31,,13265.01,Amazon,Swansea,UK
4116,29/08/2018,DEB,AMZN Mktp UK,2.79,,13272.32,Amazon,Swansea,UK
4117,29/08/2018,BP,SAVE THE CHANGE,1.1,,13275.11,Savings,Swansea,UK
4118,28/08/2018,DEB,AMZN Mktp UK,8.99,,13276.21,Amazon,Swansea,UK
4119,28/08/2018,DEB,ARRIVA TRAINS WALE,11.5,,13285.2,Travel,,
4120,28/08/2018,DEB,Brontosaurus Vegan,24.41,,13296.7,Dine Out,Swansea,UK
4121,28/08/2018,CPT,LNK UNI - UNIVERSI,40.0,,13321.11,Cash,Swansea,UK
4122,28/08/2018,BP,SAVE THE CHANGE,0.16,,13361.11,Savings,Swansea,UK
4123,28/08/2018,CPT,LNK ARRIVA TRAINS,40.0,,13361.27,Cash,,
4124,24/08/2018,DEB,PIZZA EXPRESS,86.85,,13401.27,Dine Out,,
4125,24/08/2018,DEB,Audible.co.uk,7.99,,13488.12,Entertainment,Swansea,UK
4126,24/08/2018,CPT,LNK M&S SWANSEA,20.0,,13496.11,Cash,Swansea,UK
4127,24/08/2018,BGC,SWANSEA UNIVERSITY,,276.32,13516.11,Supplementary Income,Swansea,UK
4128,22/08/2018,CPT,LNK UNI - UNIVERSI,50.0,,13239.79,Cash,Swansea,UK
4129,22/08/2018,BP,SAVE THE CHANGE,0.4,,13289.79,Savings,Swansea,UK
4130,21/08/2018,FPO,P M GREY,3500.0,,13290.19,Services,Swansea,UK
4131,21/08/2018,DEB,AMZN Mktp UK,7.98,,16790.19,Amazon,Swansea,UK
4132,21/08/2018,DEB,AMZN Mktp UK,2.62,,16798.17,Amazon,Swansea,UK
4133,21/08/2018,DD,VIRGIN MEDIA PYMTS,27.0,,16800.79,Bills,Nottingham,UK
4134,21/08/2018,BP,SAVE THE CHANGE,1.55,,16827.79,Savings,Swansea,UK
4135,20/08/2018,DEB,AMZN Mktp UK,10.0,,16829.34,Amazon,Swansea,UK
4136,20/08/2018,DEB,AMZN Mktp UK,7.25,,16839.34,Amazon,Swansea,UK
4137,20/08/2018,DEB,Brontosaurus Vegan,28.2,,16846.59,Dine Out,Swansea,UK
4138,20/08/2018,BP,SAVE THE CHANGE,0.9,,16874.79,Savings,Swansea,UK
4139,20/08/2018,CPT,LNK M&S SWANSEA,50.0,,16875.69,Cash,Swansea,UK
4140,17/08/2018,DEB,ARRIVA TRAINS WALE,87.1,,16925.69,Travel,,
4141,17/08/2018,DEB,BEAUFORT PARK HOTE,58.0,,17012.79,Hotels,New Brighton,Moldova
4142,17/08/2018,BP,SAVE THE CHANGE,1.0,,17070.79,Savings,Swansea,UK
4143,16/08/2018,DEB,AMZN Mktp UK,5.45,,17071.79,Amazon,Swansea,UK
4144,16/08/2018,DEB,AMZN Mktp UK,3.55,,17077.24,Amazon,Swansea,UK
4145,16/08/2018,CPT,LNK UNI - UNIVERSI,60.0,,17080.79,Cash,Swansea,UK
4146,16/08/2018,DD,O2,19.0,,17140.79,Other Shopping,Swansea,UK
4147,15/08/2018,BP,SAVE THE CHANGE,0.11,,17159.79,Savings,Swansea,UK
4148,14/08/2018,DEB,AMZN Mktp UK,6.89,,17159.9,Amazon,Swansea,UK
4149,14/08/2018,BP,SAVE THE CHANGE,0.6,,17166.79,Savings,Swansea,UK
4150,13/08/2018,DEB,AMZN MKTP UK AMAZO,5.4,,17167.39,Amazon,Swansea,UK
4151,2018-08-08 00:00:00,DD,LV LIFE,37.12,,17172.79,Insurance,Swansea,UK
4152,2018-06-08 00:00:00,DEB,NON-STG CASH FEE,1.5,,17209.91,Others,Swansea,UK
4153,2018-06-08 00:00:00,DEB,NON-STG TRANS FEE,2.66,,17211.41,Others,Swansea,UK
4154,2018-06-08 00:00:00,DEB,ST PAUL'S BAY,89.2,,17214.07,Travel,Malia,Greece
4155,2018-06-08 00:00:00,DD,ASSURANT INTER LTD,21.37,,17303.27,Insurance,Swansea,UK
4156,2018-02-08 00:00:00,DEP,CLUB LLOYDS WAIVED,,3.0,17324.64,Interest,Swansea,UK
4157,2018-02-08 00:00:00,PAY,CLUB LLOYDS FEE,3.0,,17321.64,Bills,Swansea,UK
4158,2018-01-08 00:00:00,,INTEREST (GROSS),,6.12,17324.64,Supplementary Income,Swansea,UK
4159,2018-01-08 00:00:00,DD,PRINCIPALITY BS,957.26,,17318.52,Mortgage,Swansea,UK
4160,2018-01-08 00:00:00,DD,CC SWANSEA C.TAX,184.0,,18275.78,Bills,Swansea,UK
4161,2018-01-08 00:00:00,DD,GOOD ENERGY LTD,97.0,,18459.78,Bills,Swansea,UK
4162,2018-01-08 00:00:00,DD,AVIVA LIFE,46.46,,18556.78,Insurance,Swansea,UK
4163,2018-01-08 00:00:00,DD,DWR CYMRU W WATER,23.5,,18603.24,Bills,Swansea,UK
4164,2018-01-08 00:00:00,DD,ZURICH,19.36,,18626.74,Insurance,Swansea,UK
4165,2018-01-08 00:00:00,SO,ESAVINGS ACCOUNT,300.0,,18646.1,Savings,Swansea,UK
4166,31/07/2018,DD,UCU B ACCOUNT,23.11,,18946.1,Others,Swansea,UK
4167,31/07/2018,BP,SAVE THE CHANGE,2.14,,18969.21,Savings,Swansea,UK
4168,31/07/2018,BGC,SWANSEA UNI - PAY,,3200.58,18971.35,Paycheck,Swansea,UK
4169,30/07/2018,DEB,NON-STG PURCH FEE,0.5,,15770.77,Others,Swansea,UK
4170,30/07/2018,DEB,NON-STG TRANS FEE,5.38,,15771.27,Others,Swansea,UK
4171,30/07/2018,DEB,Hotel on Booking.c,180.25,,15776.65,Hotels,,
4172,30/07/2018,DEB,Amazon UK Retail,9.87,,15956.9,Amazon,Swansea,UK
4173,30/07/2018,DEB,JS ONLINE GROCERY,100.55,,15966.77,Groceries,Swansea,UK
4174,30/07/2018,DEB,Brontosaurus Vegan,36.2,,16067.32,Dine Out,Swansea,UK
4175,30/07/2018,DEB,Amazon UK Marketpl,15.99,,16103.52,Amazon,Swansea,UK
4176,30/07/2018,BP,SAVE THE CHANGE,0.87,,16119.51,Savings,Swansea,UK
4177,30/07/2018,CPT,LNK 37 THE QUADANT,182.13,,16120.38,Cash,Oakham,UK
4178,27/07/2018,DEB,AMAZON SVCS EU-UK,11.13,,16302.51,Amazon,Swansea,UK
4179,27/07/2018,CPT,LNK UNI - UNIVERSI,40.0,,16313.64,Cash,Swansea,UK
4180,27/07/2018,BP,SAVE THE CHANGE,0.06,,16353.64,Savings,Swansea,UK
4181,27/07/2018,BGC,SWANSEA UNIVERSITY,,136.28,16353.7,Supplementary Income,Swansea,UK
4182,26/07/2018,DEB,Amazon UK Marketpl,42.94,,16217.42,Amazon,Swansea,UK
4183,26/07/2018,BP,SAVE THE CHANGE,0.75,,16260.36,Savings,Swansea,UK
4184,25/07/2018,DEB,Amazon UK Marketpl,4.25,,16261.11,Amazon,Swansea,UK
4185,25/07/2018,CPT,LNK UNI - UNIVERSI,60.0,,16265.36,Cash,Swansea,UK
4186,25/07/2018,BP,SAVE THE CHANGE,0.52,,16325.36,Savings,Swansea,UK
4187,24/07/2018,DEB,Amazon UK Marketpl,4.49,,16325.88,Amazon,Swansea,UK
4188,24/07/2018,DEB,Audible.co.uk,7.99,,16330.37,Entertainment,Swansea,UK
4189,24/07/2018,BP,SAVE THE CHANGE,0.5,,16338.36,Savings,Swansea,UK
4190,23/07/2018,DEB,ROOT,3.5,,16338.86,Entertainment,Swansea,UK
4191,23/07/2018,DD,VIRGIN MEDIA PYMTS,27.0,,16342.36,Bills,Nottingham,UK
4192,23/07/2018,CPT,LOYD 802 OXFORD ST,50.0,,16369.36,,,
4193,20/07/2018,CPT,LNK UNI - UNIVERSI,60.0,,16419.36,Cash,Swansea,UK
4194,17/07/2018,BP,SAVE THE CHANGE,1.55,,16479.36,Savings,Swansea,UK
4195,16/07/2018,DEB,ARRIVA TRAINS WALE,75.1,,16480.91,Travel,,
4196,16/07/2018,DEB,BIRMINGHAM INT HOT,33.0,,16556.01,Hotels,Birmingham,UK
4197,16/07/2018,DEB,Amazon UK Marketpl,5.35,,16589.01,Amazon,Swansea,UK
4198,16/07/2018,DD,O2,17.95,,16594.36,Other Shopping,Swansea,UK
4199,16/07/2018,CPT,LNK ARRIVA TRAINS,60.0,,16612.31,Cash,,
4200,13/07/2018,CPT,LNK ARRIVA TRAINS,40.0,,16672.31,Cash,,
4201,13/07/2018,BGC,SWANSEA UNIVERSITY,,939.33,16712.31,Supplementary Income,Swansea,UK
4202,2018-11-07 00:00:00,BP,SAVE THE CHANGE,0.7,,15772.98,Savings,Swansea,UK
4203,2018-10-07 00:00:00,DEB,ARRIVA TRAINS WALE,128.3,,15773.68,Travel,,
4204,2018-10-07 00:00:00,DEB,THE ALBANY HOTEL,75.0,,15901.98,Hotels,,
4205,2018-09-07 00:00:00,CPT,LNK UNI - UNIVERSI,40.0,,15976.98,Cash,Swansea,UK
4206,2018-09-07 00:00:00,DD,LV LIFE,37.12,,16016.98,Insurance,Swansea,UK
4207,2018-09-07 00:00:00,BP,SAVE THE CHANGE,0.91,,16054.1,Savings,Swansea,UK
4208,2018-06-07 00:00:00,DEB,AMAZON EU AMAZON.C,7.09,,16055.01,Amazon,Swansea,UK
4209,2018-06-07 00:00:00,BP,SAVE THE CHANGE,1.39,,16062.1,Savings,Swansea,UK
4210,2018-05-07 00:00:00,DEB,WATSON & PRATTS,92.53,,16063.49,Groceries ,Lampeter,UK
4211,2018-05-07 00:00:00,DEB,Amazon UK Retail,19.08,,16156.02,Amazon,Swansea,UK
4212,2018-04-07 00:00:00,DEP,CLUB LLOYDS WAIVED,,3.0,16175.1,Supplementary Income,Swansea,UK
4213,2018-04-07 00:00:00,PAY,CLUB LLOYDS FEE,3.0,,16172.1,Bills,Swansea,UK
4214,2018-04-07 00:00:00,BP,SAVE THE CHANGE,0.52,,16175.1,Savings,Swansea,UK
4215,2018-03-07 00:00:00,DEB,Amazon UK Marketpl,12.48,,16175.62,Amazon,Swansea,UK
4216,2018-03-07 00:00:00,DD,ASSURANT INTER LTD,21.37,,16188.1,Insurance,Swansea,UK
4217,2018-03-07 00:00:00,DD,ZURICH,19.36,,16209.47,Insurance,Swansea,UK
4218,2018-03-07 00:00:00,BP,SAVE THE CHANGE,0.01,,16228.83,Savings,Swansea,UK
4219,2018-02-07 00:00:00,,INTEREST (GROSS),,8.28,16228.84,Interest,Swansea,UK
4220,2018-02-07 00:00:00,DEB,Amazon UK Marketpl,16.99,,16220.56,Amazon,Swansea,UK
4221,2018-02-07 00:00:00,DD,PRINCIPALITY BS,957.26,,16237.55,Mortgage,Swansea,UK
4222,2018-02-07 00:00:00,DD,CC SWANSEA C.TAX,184.0,,17194.81,Bills,Swansea,UK
4223,2018-02-07 00:00:00,DD,GOOD ENERGY LTD,97.0,,17378.81,Bills,Swansea,UK
4224,2018-02-07 00:00:00,DD,AVIVA LIFE,46.46,,17475.81,Insurance,Swansea,UK
4225,2018-02-07 00:00:00,DD,DWR CYMRU W WATER,23.5,,17522.27,Bills,Swansea,UK
4226,2018-02-07 00:00:00,SO,ESAVINGS ACCOUNT,300.0,,17545.77,Savings,Swansea,UK
4227,2018-02-07 00:00:00,BP,SAVE THE CHANGE,1.32,,17845.77,Savings,Swansea,UK
4228,2018-02-07 00:00:00,DEB,NON-STG PURCH FEE,0.5,,17847.09,Others,Swansea,UK
4229,2018-02-07 00:00:00,DEB,NON-STG TRANS FEE,7.16,,17847.59,Others,Swansea,UK
4230,2018-02-07 00:00:00,DEB,Hotel on Booking.c,239.51,,17854.75,Hotels,,
4231,29/06/2018,DEB,RYANAIR   224000,251.38,,18094.26,Travel,,
4232,29/06/2018,DD,UCU B ACCOUNT,23.11,,18345.64,Others,Swansea,UK
4233,29/06/2018,DEB,NON-STG PURCH FEE,0.5,,18368.75,Others,Swansea,UK
4234,29/06/2018,DEB,NON-STG TRANS FEE,5.34,,18369.25,Others,Swansea,UK
4235,29/06/2018,DEB,Hotel on Booking.c,178.79,,18374.59,Hotels,,
4236,29/06/2018,BGC,SWANSEA UNI - PAY,,3200.58,18553.38,Paycheck,Swansea,UK
4237,26/06/2018,BP,SAVE THE CHANGE,1.11,,15352.8,Savings,Swansea,UK
4238,25/06/2018,DEB,MARKS&SPENCER PLC,2.5,,15353.91,Clothes,,
4239,25/06/2018,DEB,Audible.co.uk,7.99,,15356.41,Entertainment,Swansea,UK
4240,25/06/2018,DEB,ARRIVA TRAINS WALE,96.4,,15364.4,Travel,,
4241,25/06/2018,CPT,LNK UNI - UNIVERSI,50.0,,15460.8,Cash,Swansea,UK
4242,25/06/2018,CPT,LNK M&S SWANSEA,60.0,,15510.8,Cash,Swansea,UK
4243,22/06/2018,BP,SAVE THE CHANGE,0.03,,15570.8,Savings,Swansea,UK
4244,22/06/2018,BGC,SWANSEA UNIVERSITY,,604.21,15570.83,Supplementary Income,Swansea,UK
4245,21/06/2018,CPT,LNK GREATER ANGLIA,50.0,,14966.62,Cash,,
4246,21/06/2018,DEB,AMAZON EU AMAZON.C,24.98,,15016.62,Amazon,Swansea,UK
4247,21/06/2018,DEB,AMAZON EU AMAZON.C,9.99,,15041.6,Amazon,Swansea,UK
4248,21/06/2018,DD,VIRGIN MEDIA PYMTS,27.0,,15051.59,Bills,Nottingham,UK
4249,18/06/2018,DD,O2,18.3,,15078.59,Other Shopping,Swansea,UK
4250,15/06/2018,CPT,LNK UNI - UNIVERSI,50.0,,15096.89,Cash,Swansea,UK
4251,15/06/2018,BP,SAVE THE CHANGE,0.32,,15146.89,Savings,Swansea,UK
4252,14/06/2018,DEB,NON-STG PURCH FEE,0.5,,15147.21,Others,Swansea,UK
4253,14/06/2018,DEB,NON-STG TRANS FEE,7.34,,15147.71,Others,Swansea,UK
4254,14/06/2018,DEB,HOTEL PRAGUE CASTL,245.68,,15155.05,Hotels,Prague,Czech Republic
4255,2018-12-06 00:00:00,BP,SAVE THE CHANGE,1.91,,15400.73,Savings,Swansea,UK
4256,2018-11-06 00:00:00,DEB,NON-STG PURCH FEE,0.5,,15402.64,Others,Swansea,UK
4257,2018-11-06 00:00:00,DEB,NON-STG TRANS FEE,10.83,,15403.14,Others,Swansea,UK
4258,2018-11-06 00:00:00,DEB,RECEPCE,362.21,,15413.97,Others,Swansea,UK
4259,2018-11-06 00:00:00,DEB,FOREIGN CASH FEE,1.5,,15776.18,Travel,,
4260,2018-11-06 00:00:00,DEB,WILSONOVA 300/8,114.02,,15777.68,Travel,Vinohrady,Prague
4261,2018-11-06 00:00:00,DEB,NON-STG PURCH FEE,0.5,,15891.7,Others,Swansea,UK
4262,2018-11-06 00:00:00,DEB,NON-STG TRANS FEE,0.45,,15892.2,Others,Swansea,UK
4263,2018-11-06 00:00:00,DEB,BIOPOINT,15.37,,15892.65,Other Shopping,,
4264,2018-11-06 00:00:00,DEB,NON-STG PURCH FEE,0.5,,15908.02,Others,Swansea,UK
4265,2018-11-06 00:00:00,DEB,NON-STG TRANS FEE,0.22,,15908.52,Others,Swansea,UK
4266,2018-11-06 00:00:00,DEB,CD BRNO HL.N.,7.51,,15908.74,Travel,Brno,Czech Republic
4267,2018-08-06 00:00:00,DD,LV LIFE,37.12,,15916.25,Insurance,Swansea,UK
4268,2018-06-06 00:00:00,BP,SAVE THE CHANGE,0.95,,15953.37,Savings,Swansea,UK
4269,2018-05-06 00:00:00,DEB,Acron Czech s.r.o.,95.05,,15954.32,Hotels,Prague,Czech Republic
4270,2018-04-06 00:00:00,DEP,CLUB LLOYDS WAIVED,,3.0,16049.37,Insurance,Swansea,UK
4271,2018-04-06 00:00:00,PAY,CLUB LLOYDS FEE,3.0,,16046.37,Bills,Swansea,UK
4272,2018-04-06 00:00:00,DD,ASSURANT INTER LTD,21.37,,16049.37,Supplementary Income,Swansea,UK
4273,2018-04-06 00:00:00,BP,SAVE THE CHANGE,0.01,,16070.74,Savings,Swansea,UK
4274,2018-01-06 00:00:00,,INTEREST (GROSS),,8.42,16070.75,Interest,Swansea,UK
4275,2018-01-06 00:00:00,DEB,AMAZON SVCS EU-UK,11.99,,16062.33,Amazon,Swansea,UK
4276,2018-01-06 00:00:00,DD,PRINCIPALITY BS,957.26,,16074.32,Mortgage,Swansea,UK
4277,2018-01-06 00:00:00,DD,CC SWANSEA C.TAX,184.0,,17031.58,Bills,Swansea,UK
4278,2018-01-06 00:00:00,DD,GOOD ENERGY LTD,97.0,,17215.58,Bills,Swansea,UK
4279,2018-01-06 00:00:00,DD,AVIVA LIFE,46.46,,17312.58,Insurance,Swansea,UK
4280,2018-01-06 00:00:00,DD,DWR CYMRU W WATER,23.5,,17359.04,Bills,Swansea,UK
4281,2018-01-06 00:00:00,DD,ZURICH,19.36,,17382.54,Insurance,Swansea,UK
4282,2018-01-06 00:00:00,SO,ESAVINGS ACCOUNT,300.0,,17401.9,Savings,Swansea,UK
4283,31/05/2018,DD,UCU B ACCOUNT,23.11,,17701.9,Others,Swansea,UK
4284,31/05/2018,BP,SAVE THE CHANGE,0.12,,17725.01,Savings,Swansea,UK
4285,31/05/2018,BGC,SWANSEA UNI - PAY,,3200.58,17725.13,Paycheck,Swansea,UK
4286,30/05/2018,DEB,RYANAIR   224000,208.88,,14524.55,Travel,,
4287,30/05/2018,BP,SAVE THE CHANGE,1.7,,14733.43,Savings,Swansea,UK
4288,29/05/2018,DEB,Amazon UK Marketpl,59.98,,14735.13,Amazon,Swansea,UK
4289,29/05/2018,DEB,Amazon UK Marketpl,3.07,,14795.11,Amazon,Swansea,UK
4290,29/05/2018,DEB,ROOT,4.25,,14798.18,Entertainment,Swansea,UK
4291,29/05/2018,CPT,LNK 37 THE QUADANT,105.62,,14802.43,Cash,Oakham,UK
4292,29/05/2018,CPT,LNK M&S SWANSEA,50.0,,14908.05,Cash,Swansea,UK
4293,25/05/2018,CPT,LNK UNI - UNIVERSI,60.0,,14958.05,Cash,Swansea,UK
4294,25/05/2018,BP,SAVE THE CHANGE,0.01,,15018.05,Savings,Swansea,UK
4295,24/05/2018,DEB,Audible Ltd,7.99,,15018.06,Entertainment,Swansea,UK
4296,23/05/2018,DEB,THE BIKE HUB,105.0,,15026.05,Other Shopping,,
4297,22/05/2018,BP,SAVE THE CHANGE,0.52,,15131.05,Savings,Swansea,UK
4298,21/05/2018,DEB,Brontosaurus Vegan,19.48,,15131.57,Dine Out,Swansea,UK
4299,21/05/2018,CPT,LNK UNI - UNIVERSI,50.0,,15151.05,Cash,Swansea,UK
4300,21/05/2018,DD,VIRGIN MEDIA PYMTS,27.0,,15201.05,Bills,Nottingham,UK
4301,18/05/2018,CPT,LNK UNI - UNIVERSI,50.0,,15228.05,Cash,Swansea,UK
4302,16/05/2018,DD,O2,26.54,,15278.05,Other Shopping,Swansea,UK
4303,16/05/2018,BP,SAVE THE CHANGE,0.05,,15304.59,Savings,Swansea,UK
4304,15/05/2018,DEB,Amazon UK Marketpl,33.95,,15304.64,Amazon,Swansea,UK
4305,14/05/2018,FPI,BAMFORD C   ADGD,,33.45,15338.59,Supplementary Income,Swansea,UK
4306,14/05/2018,CPT,LNK M&S SWANSEA,50.0,,15305.14,Cash,Swansea,UK
4307,2018-11-05 00:00:00,CPT,LNK UNI - UNIVERSI,50.0,,15355.14,Cash,Swansea,UK
4308,2018-11-05 00:00:00,DD,LV LIFE,37.12,,15405.14,Insurance,Swansea,UK
4309,2018-11-05 00:00:00,BP,SAVE THE CHANGE,0.53,,15442.26,Savings,Swansea,UK
4310,2018-10-05 00:00:00,TFR,P M GREY,2500.0,,15442.79,Services,Swansea,UK
4311,2018-10-05 00:00:00,DEB,AMAZON EU AMAZON.C,39.47,,17942.79,Amazon,Swansea,UK
4312,2018-09-05 00:00:00,BP,SAVE THE CHANGE,0.03,,17982.26,Savings,Swansea,UK
4313,2018-08-05 00:00:00,DEB,Amazon UK Marketpl,14.97,,17982.29,Amazon,Swansea,UK
4314,2018-03-05 00:00:00,DD,ASSURANT INTER LTD,21.37,,17997.26,Insurance,Swansea,UK
4315,2018-03-05 00:00:00,DD,PAYPAL PAYMENT,3.84,,18018.63,Others,Swansea,UK
4316,2018-03-05 00:00:00,BP,SAVE THE CHANGE,0.51,,18022.47,Savings,Swansea,UK
4317,2018-02-05 00:00:00,DEB,Amazon UK Retail,24.49,,18022.98,Amazon,Swansea,UK
4318,2018-02-05 00:00:00,TFR,P M GREY,2000.0,,18047.47,Services,Swansea,UK
4319,2018-01-05 00:00:00,FEE,SILVER ACCOUNT,9.59,,20047.47,Bills,Swansea,UK
4320,2018-01-05 00:00:00,,INTEREST (GROSS),,0.27,20057.06,Interest,Swansea,UK
4321,2018-01-05 00:00:00,DD,PRINCIPALITY BS,957.26,,20056.79,Mortgage,Swansea,UK
4322,2018-01-05 00:00:00,DD,CC SWANSEA C.TAX,184.0,,21014.05,Bills,Swansea,UK
4323,2018-01-05 00:00:00,DD,GOOD ENERGY LTD,97.0,,21198.05,Bills,Swansea,UK
4324,2018-01-05 00:00:00,DD,AVIVA LIFE,46.46,,21295.05,Insurance,Swansea,UK
4325,2018-01-05 00:00:00,DD,DWR CYMRU W WATER,23.5,,21341.51,Bills,Swansea,UK
4326,2018-01-05 00:00:00,DD,ZURICH,19.36,,21365.01,Insurance,Swansea,UK
4327,2018-01-05 00:00:00,SO,ESAVINGS ACCOUNT,300.0,,21384.37,Savings,Swansea,UK
4328,2018-01-05 00:00:00,BP,SAVE THE CHANGE,0.97,,21684.37,Savings,Swansea,UK
4329,30/04/2018,DEB,Amazon UK Marketpl,21.03,,21685.34,Amazon,Swansea,UK
4330,30/04/2018,DD,UCU B ACCOUNT,23.11,,21706.37,Others,Swansea,UK
4331,30/04/2018,BP,SAVE THE CHANGE,0.11,,21729.48,Savings,Swansea,UK
4332,30/04/2018,BGC,SWANSEA UNI - PAY,,3200.98,21729.59,Paycheck,Swansea,UK
4333,30/04/2018,CPT,LOYD 802 OXFORD ST,50.0,,18528.61,,,
4334,27/04/2018,DEB,KLM UK  074532,260.89,,18578.61,Travel,,
4335,27/04/2018,CPT,LNK UNI - UNIVERSI,60.0,,18839.5,Cash,Swansea,UK
4336,27/04/2018,BP,SAVE THE CHANGE,0.12,,18899.5,Savings,Swansea,UK
4337,26/04/2018,DEB,Amazon UK Marketpl,51.88,,18899.62,Amazon,Swansea,UK
4338,26/04/2018,DEB,EXPEDIA 7347956738,3.0,,18951.5,Travel,,
4339,26/04/2018,BP,SAVE THE CHANGE,0.98,,18954.5,Savings,Swansea,UK
4340,25/04/2018,DEB,AMAZON SVCS EU-UK,9.02,,18955.48,Amazon,Swansea,UK
4341,25/04/2018,CPT,LNK UNI - UNIVERSI,50.0,,18964.5,Cash,Swansea,UK
4342,25/04/2018,BP,SAVE THE CHANGE,1.79,,19014.5,Savings,Swansea,UK
4343,24/04/2018,DEB,Audible Ltd,7.99,,19016.29,Entertainment,Swansea,UK
4344,24/04/2018,DEB,AMAZON EU AMAZON.C,5.39,,19024.28,Amazon,Swansea,UK
4345,24/04/2018,DEB,NON-STG PURCH FEE,0.5,,19029.67,Others,Swansea,UK
4346,24/04/2018,DEB,NON-STG TRANS FEE,1.05,,19030.17,Others,Swansea,UK
4347,24/04/2018,DEB,KLM FSSC BUD SCHI,35.16,,19031.22,Travel,Budapest,Hungary
4348,24/04/2018,DEB,NON-STG PURCH FEE,0.5,,19066.38,Others,Swansea,UK
4349,24/04/2018,DEB,NON-STG TRANS FEE,0.28,,19066.88,Others,Swansea,UK
4350,24/04/2018,DEB,NS DELFT,9.67,,19067.16,Travel,Amsterdam,Netherlands
4351,24/04/2018,BP,SAVE THE CHANGE,0.72,,19076.83,Savings,Swansea,UK
4352,23/04/2018,DEB,AMAZON SVCS EU-UK,8.79,,19077.55,Amazon,Swansea,UK
4353,23/04/2018,DEB,GOOGLE *YouTube Vi,3.49,,19086.34,,,
4354,23/04/2018,DD,VIRGIN MEDIA PYMTS,27.0,,19089.83,Bills,Nottingham,UK
4355,20/04/2018,DEB,NON-STG CASH FEE,1.5,,19116.83,Others,Swansea,UK
4356,20/04/2018,DEB,NON-STG TRANS FEE,3.91,,19118.33,Others,Swansea,UK
4357,20/04/2018,DEB,ABN-AMRO,130.85,,19122.24,Travel,,
4358,20/04/2018,DEB,NON-STG CASH FEE,1.5,,19253.09,Others,Swansea,UK
4359,20/04/2018,DEB,NON-STG TRANS FEE,5.21,,19254.59,Others,Swansea,UK
4360,20/04/2018,DEB,ABN-AMRO,174.47,,19259.8,Travel,,
4361,20/04/2018,DEB,NON-STG CASH FEE,1.5,,19434.27,Others,Swansea,UK
4362,20/04/2018,DEB,NON-STG TRANS FEE,5.21,,19435.77,Others,Swansea,UK
4363,20/04/2018,DEB,ABN-AMRO,174.47,,19440.98,Travel,,
4364,20/04/2018,DEB,NON-STG CASH FEE,1.5,,19615.45,Others,Swansea,UK
4365,20/04/2018,DEB,NON-STG TRANS FEE,1.3,,19616.95,Others,Swansea,UK
4366,20/04/2018,DEB,ABN-AMRO,43.62,,19618.25,Travel,,
4367,19/04/2018,BP,SAVE THE CHANGE,0.31,,19661.87,Savings,Swansea,UK
4368,18/04/2018,DEB,NON-STG PURCH FEE,0.5,,19662.18,Others,Swansea,UK
4369,18/04/2018,DEB,NON-STG TRANS FEE,0.61,,19662.68,Others,Swansea,UK
4370,18/04/2018,DEB,PLUS 488,20.69,,19663.29,Others,Swansea,UK
4371,17/04/2018,BP,SAVE THE CHANGE,1.02,,19683.98,Savings,Swansea,UK
4372,16/04/2018,DEB,NON-STG PURCH FEE,0.5,,19685.0,Others,Swansea,UK
4373,16/04/2018,DEB,NON-STG TRANS FEE,0.28,,19685.5,Others,Swansea,UK
4374,16/04/2018,DEB,NS SCHIPHOL,9.53,,19685.78,Travel,Amsterdam,Netherlands
4375,16/04/2018,DEB,AMAZON EU AMAZON.C,22.45,,19695.31,Amazon,Swansea,UK
4376,16/04/2018,DD,O2,23.18,,19717.76,Other Shopping,Swansea,UK
4377,16/04/2018,CPT,LNK ARRIVA TRAINS,40.0,,19740.94,Cash,,
4378,16/04/2018,FPO,DEZREZ LEGAL LTD,25.8,,19780.94,Mortgage,Nottingham,UK
4379,13/04/2018,CPT,LNK UNI - UNIVERSI,100.0,,19806.74,Cash,Swansea,UK
4380,2018-12-04 00:00:00,BP,SAVE THE CHANGE,1.1,,19906.74,Savings,Swansea,UK
4381,2018-11-04 00:00:00,DEB,AMAZON SVCS EU-UK,1.74,,19907.84,Amazon,Swansea,UK
4382,2018-11-04 00:00:00,DEB,AMAZON SVCS EU-UK,18.16,,19909.58,Amazon,Swansea,UK
4383,2018-10-04 00:00:00,CPT,LNK UNI - UNIVERSI,50.0,,19927.74,Cash,Swansea,UK
4384,2018-10-04 00:00:00,BP,SAVE THE CHANGE,2.34,,19977.74,Savings,Swansea,UK
4385,2018-09-04 00:00:00,DEB,B & Q 1213,32.67,,19980.08,Home Improvement,Swansea,UK
4386,2018-09-04 00:00:00,DEB,AMAZON SVCS EU-UK,31.58,,20012.75,Amazon,Swansea,UK
4387,2018-09-04 00:00:00,DEB,AMAZON SVCS EU-UK,21.03,,20044.33,Amazon,Swansea,UK
4388,2018-09-04 00:00:00,DEB,Amazon UK Marketpl,16.55,,20065.36,Amazon,Swansea,UK
4389,2018-09-04 00:00:00,DEB,AMAZON EU AMAZON.C,13.85,,20081.91,Amazon,Swansea,UK
4390,2018-09-04 00:00:00,DEB,T K MAXX,12.98,,20095.76,Other Shopping,,
4391,2018-09-04 00:00:00,DD,LV LIFE,37.12,,20108.74,Insurance,Swansea,UK
4392,2018-09-04 00:00:00,BP,SAVE THE CHANGE,0.1,,20145.86,Savings,Swansea,UK
4393,2018-06-04 00:00:00,DEB,AMAZON SVCS EU-UK,15.9,,20145.96,Amazon,Swansea,UK
4394,2018-05-04 00:00:00,DD,ZURICH,19.36,,20161.86,Insurance,Swansea,UK
4395,2018-05-04 00:00:00,BP,SAVE THE CHANGE,0.01,,20181.22,Savings,Swansea,UK
4396,2018-04-04 00:00:00,DEB,AMAZON SVCS EU-UK,78.99,,20181.23,Amazon,Swansea,UK
4397,2018-04-04 00:00:00,BP,SAVE THE CHANGE,0.94,,20260.22,Savings,Swansea,UK
4398,2018-03-04 00:00:00,FEE,ACCOUNT FEE,9.95,,20261.16,Bills,Swansea,UK
4399,2018-03-04 00:00:00,DEB,AMAZON EU AMAZON.C,69.99,,20271.11,Amazon,Swansea,UK
4400,2018-03-04 00:00:00,DEB,AMAZON SVCS EU-UK,5.48,,20341.1,Amazon,Swansea,UK
4401,2018-03-04 00:00:00,DEB,AMAZON SVCS EU-UK,3.59,,20346.58,Amazon,Swansea,UK
4402,2018-03-04 00:00:00,DD,PRINCIPALITY BS,957.26,,20350.17,Mortgage,Swansea,UK
4403,2018-03-04 00:00:00,DD,CC SWANSEA C.TAX,179.97,,21307.43,Bills,Swansea,UK
4404,2018-03-04 00:00:00,DD,GOOD ENERGY LTD,97.0,,21487.4,Bills,Swansea,UK
4405,2018-03-04 00:00:00,DD,AVIVA LIFE,46.46,,21584.4,Insurance,Swansea,UK
4406,2018-03-04 00:00:00,DD,ASSURANT INTER LTD,21.37,,21630.86,Insurance,Swansea,UK
4407,2018-03-04 00:00:00,SO,ESAVINGS ACCOUNT,300.0,,21652.23,Savings,Swansea,UK
4408,2018-03-04 00:00:00,BGC,SWANSEA UNIVERSITY,,175.7,21952.23,Supplementary Income,Swansea,UK
4409,2018-03-04 00:00:00,FPI,PAYPAL CODE 3241,,0.01,21776.53,Supplementary Income,Swansea,UK
4410,2018-03-04 00:00:00,CPT,LNK M&S SWANSEA,50.0,,21776.52,Cash,Swansea,UK
4411,29/03/2018,DD,UCU B ACCOUNT,23.11,,21826.52,Others,Swansea,UK
4412,29/03/2018,BGC,SWANSEA UNI - PAY,,3180.97,21849.63,Paycheck,Swansea,UK
4413,27/03/2018,CPT,LNK UNI - UNIVERSI,50.0,,18668.66,Cash,Swansea,UK
4414,27/03/2018,BP,SAVE THE CHANGE,0.08,,18718.66,Savings,Swansea,UK
4415,26/03/2018,DEB,AMAZON SVCS EU-UK,45.99,,18718.74,Amazon,Swansea,UK
4416,26/03/2018,DEB,AMAZON SVCS EU-UK,6.99,,18764.73,Amazon,Swansea,UK
4417,26/03/2018,DEB,AMAZON SVCS EU-UK,6.95,,18771.72,Amazon,Swansea,UK
4418,26/03/2018,DEB,Audible Ltd,7.99,,18778.67,Entertainment,Swansea,UK
4419,26/03/2018,BP,SAVE THE CHANGE,1.72,,18786.66,Savings,Swansea,UK
4420,26/03/2018,CPT,LNK M&S SWANSEA,50.0,,18788.38,Cash,Swansea,UK
4421,23/03/2018,DEB,AMAZON SVCS EU-UK,21.03,,18838.38,Amazon,Swansea,UK
4422,23/03/2018,DEB,AMAZON SVCS EU-UK,8.25,,18859.41,Amazon,Swansea,UK
4423,23/03/2018,CPT,LNK UNI - UNIVERSI,50.0,,18867.66,Cash,Swansea,UK
4424,21/03/2018,DD,VIRGIN MEDIA PYMTS,27.0,,18917.66,Bills,Nottingham,UK
4425,20/03/2018,BP,SAVE THE CHANGE,1.27,,18944.66,Savings,Swansea,UK
4426,19/03/2018,DEB,AMAZON SVCS EU-UK,14.99,,18945.93,Amazon,Swansea,UK
4427,19/03/2018,DEB,Amazon UK Marketpl,3.65,,18960.92,Amazon,Swansea,UK
4428,19/03/2018,DEB,KLM UK  074532,224.09,,18964.57,Travel,,
4429,19/03/2018,BP,SAVE THE CHANGE,1.78,,19188.66,Savings,Swansea,UK
4430,19/03/2018,CPT,LOYD 802 OXFORD ST,50.0,,19190.44,,,
4431,19/03/2018,CHQ,LOYD 802 OXFORD ST,,79.05,19240.44,Supplementary Income,Swansea,UK
4432,16/03/2018,DEB,Amazon *Mktplce EU,10.12,,19161.39,Amazon,Swansea,UK
4433,16/03/2018,DEB,EXPEDIA 7337347949,2.1,,19171.51,Travel,,
4434,16/03/2018,CPT,LNK UNI - UNIVERSI,60.0,,19173.61,Cash,Swansea,UK
4435,16/03/2018,DD,O2,17.26,,19233.61,Other Shopping,Swansea,UK
4436,15/03/2018,BP,SAVE THE CHANGE,0.32,,19250.87,Savings,Swansea,UK
4437,14/03/2018,DEB,AMAZON EU AMAZON.C,17.68,,19251.19,Amazon,Swansea,UK
4438,13/03/2018,BP,SAVE THE CHANGE,0.65,,19268.87,Savings,Swansea,UK
4439,2018-12-03 00:00:00,DEB,GOOGLE *YouTube Vi,3.49,,19269.52,,,
4440,2018-12-03 00:00:00,DEB,Amazon UK Marketpl,42.95,,19273.01,Amazon,Swansea,UK
4441,2018-12-03 00:00:00,DEB,AMAZON MKTPLACE PM,17.91,,19315.96,Amazon,Swansea,UK
4442,2018-09-03 00:00:00,DEB,Amazon Prime,79.0,,19333.87,Amazon,Swansea,UK
4443,2018-09-03 00:00:00,DD,LV LIFE,37.12,,19412.87,Insurance,Swansea,UK
4444,2018-07-03 00:00:00,BP,SAVE THE CHANGE,0.97,,19449.99,Savings,Swansea,UK
4445,2018-06-03 00:00:00,DEB,AMAZON SVCS EU-UK,21.03,,19450.96,Amazon,Swansea,UK
4446,2018-06-03 00:00:00,DD,ASSURANT INTER LTD,21.37,,19471.99,Insurance,Swansea,UK
4447,2018-06-03 00:00:00,BP,SAVE THE CHANGE,0.46,,19493.36,Savings,Swansea,UK
4448,2018-05-03 00:00:00,DEB,Amazon UK Marketpl,94.54,,19493.82,Amazon,Swansea,UK
4449,2018-05-03 00:00:00,DEB,Amazon UK Marketpl,32.0,,19588.36,Amazon,Swansea,UK
4450,2018-05-03 00:00:00,BP,SAVE THE CHANGE,0.25,,19620.36,Savings,Swansea,UK
4451,2018-02-03 00:00:00,DEB,BLS*WWWPLEDGEMUSIC,14.75,,19620.61,Entertainment,Swansea,UK
4452,2018-02-03 00:00:00,BP,SAVE THE CHANGE,0.85,,19635.36,Savings,Swansea,UK
4453,2018-01-03 00:00:00,FEE,ACCOUNT FEE,9.95,,19636.21,Bills,Swansea,UK
4454,2018-01-03 00:00:00,DEB,AMAZON SVCS EU-UK,46.0,,19646.16,Amazon,Swansea,UK
4455,2018-01-03 00:00:00,DEB,AMAZON SVCS EU-UK,16.76,,19692.16,Amazon,Swansea,UK
4456,2018-01-03 00:00:00,DEB,AMAZON MKTPLACE PM,13.39,,19708.92,Amazon,Swansea,UK
4457,2018-01-03 00:00:00,DD,PRINCIPALITY BS,957.26,,19722.31,Mortgage,Swansea,UK
4458,2018-01-03 00:00:00,DD,CC SWANSEA C.TAX,580.0,,20679.57,Bills,Swansea,UK
4459,2018-01-03 00:00:00,DD,GOOD ENERGY LTD,85.0,,21259.57,Bills,Swansea,UK
4460,2018-01-03 00:00:00,DD,AVIVA LIFE,46.46,,21344.57,Insurance,Swansea,UK
4461,2018-01-03 00:00:00,DD,DWR CYMRU W WATER,33.5,,21391.03,Bills,Swansea,UK
4462,2018-01-03 00:00:00,DD,ZURICH,19.36,,21424.53,Insurance,Swansea,UK
4463,2018-01-03 00:00:00,SO,ESAVINGS ACCOUNT,300.0,,21443.89,Savings,Swansea,UK
4464,28/02/2018,DD,UCU B ACCOUNT,23.11,,21743.89,Others,Swansea,UK
4465,28/02/2018,BP,SAVE THE CHANGE,0.55,,21767.0,Savings,Swansea,UK
4466,28/02/2018,BGC,SWANSEA UNI - PAY,,3180.97,21767.55,Paycheck,Swansea,UK
4467,28/02/2018,BGC,MIDDLESEX UNIV,,357.99,18586.58,Supplementary Income,Swansea,UK
4468,27/02/2018,DEB,Amazon UK Marketpl,12.45,,18228.59,Amazon,Swansea,UK
4469,27/02/2018,BP,SAVE THE CHANGE,0.53,,18241.04,Savings,Swansea,UK
4470,26/02/2018,DEB,AMAZON SVCS EU-UK,11.49,,18241.57,Amazon,Swansea,UK
4471,26/02/2018,DEB,Amazon UK Marketpl,9.99,,18253.06,Amazon,Swansea,UK
4472,26/02/2018,DEB,Audible Ltd,7.99,,18263.05,Entertainment,Swansea,UK
4473,26/02/2018,DEB,AMAZON EU AMAZON.C,,18.6,18271.04,Supplementary Income,Swansea,UK
4474,23/02/2018,CPT,LNK UNI - UNIVERSI,20.0,,18252.44,Cash,Swansea,UK
4475,23/02/2018,BGC,SWANSEA UNIVERSITY,,724.39,18272.44,Supplementary Income,Swansea,UK
4476,22/02/2018,CPT,LNK UNI - UNIVERSI,50.0,,17548.05,Cash,Swansea,UK
4477,22/02/2018,BP,SAVE THE CHANGE,0.1,,17598.05,Savings,Swansea,UK
4478,21/02/2018,DEB,AMAZON SVCS EU-UK,15.9,,17598.15,Amazon,Swansea,UK
4479,21/02/2018,DD,VIRGIN MEDIA PYMTS,27.0,,17614.05,Bills,Nottingham,UK
4480,20/02/2018,BP,SAVE THE CHANGE,1.94,,17641.05,Savings,Swansea,UK
4481,19/02/2018,DEB,Amazon UK Retail,19.38,,17642.99,Amazon,Swansea,UK
4482,19/02/2018,DEB,AMAZON EU AMAZON.C,18.6,,17662.37,Amazon,Swansea,UK
4483,19/02/2018,DEB,Amazon UK Marketpl,2.08,,17680.97,Amazon,Swansea,UK
4484,19/02/2018,CPT,LNK UNI - UNIVERSI,40.0,,17683.05,Cash,Swansea,UK
4485,16/02/2018,CPT,LNK UNI - UNIVERSI,40.0,,17723.05,Cash,Swansea,UK
4486,16/02/2018,DD,O2,17.26,,17763.05,Other Shopping,Swansea,UK
4487,15/02/2018,BP,SAVE THE CHANGE,0.55,,17780.31,Savings,Swansea,UK
4488,14/02/2018,DEB,Amazon UK Marketpl,17.45,,17780.86,Amazon,Swansea,UK
4489,14/02/2018,DEB,Amazon UK Retail,6.0,,17798.31,Amazon,Swansea,UK
4490,14/02/2018,CPT,LNK UNI - UNIVERSI,50.0,,17804.31,Cash,Swansea,UK
4491,14/02/2018,BP,SAVE THE CHANGE,0.37,,17854.31,Savings,Swansea,UK
4492,13/02/2018,DEB,Amazon UK Marketpl,108.98,,17854.68,Amazon,Swansea,UK
4493,13/02/2018,DEB,AMAZON SVCS EU-UK,3.65,,17963.66,Amazon,Swansea,UK
4494,2018-12-02 00:00:00,BP,SAVE THE CHANGE,0.21,,17967.31,Savings,Swansea,UK
4495,2018-09-02 00:00:00,DEB,AMAZON SVCS EU-UK,21.79,,17967.52,Amazon,Swansea,UK
4496,2018-09-02 00:00:00,CPT,LNK UNI - UNIVERSI,40.0,,17989.31,Cash,Swansea,UK
4497,2018-09-02 00:00:00,DD,LV LIFE,37.12,,18029.31,Insurance,Swansea,UK
4498,2018-07-02 00:00:00,CPT,LNK UNI - UNIVERSI,40.0,,18066.43,Cash,Swansea,UK
4499,2018-07-02 00:00:00,CHQ,LOYD 802 OXFORD ST,,2.72,18106.43,Supplementary Income,Swansea,UK
4500,2018-07-02 00:00:00,BP,SAVE THE CHANGE,0.63,,18103.71,Savings,Swansea,UK
4501,2018-06-02 00:00:00,DEB,AMAZON SVCS EU-UK,16.89,,18104.34,Amazon,Swansea,UK
4502,2018-06-02 00:00:00,DEB,AMAZON SVCS EU-UK,14.48,,18121.23,Amazon,Swansea,UK
4503,2018-06-02 00:00:00,DD,ASSURANT INTER LTD,21.37,,18135.71,Insurance,Swansea,UK
4504,2018-06-02 00:00:00,BP,SAVE THE CHANGE,0.01,,18157.08,Savings,Swansea,UK
4505,2018-05-02 00:00:00,DEB,AMAZON SVCS EU-UK,39.99,,18157.09,Amazon,Swansea,UK
4506,2018-05-02 00:00:00,DEB,BIRMINGHAM INT HOT,37.0,,18197.08,Hotels,Birmingham,UK
4507,2018-05-02 00:00:00,CPT,LNK UNI - UNIVERSI,50.0,,18234.08,Cash,Swansea,UK
4508,2018-05-02 00:00:00,BP,SAVE THE CHANGE,0.6,,18284.08,Savings,Swansea,UK
4509,2018-02-02 00:00:00,DEB,AMAZON SVCS EU-UK,17.4,,18284.68,Amazon,Swansea,UK
4510,2018-02-02 00:00:00,BP,SAVE THE CHANGE,0.8,,18302.08,Savings,Swansea,UK
4511,2018-01-02 00:00:00,FEE,ACCOUNT FEE,9.95,,18302.88,Bills,Swansea,UK
4512,2018-01-02 00:00:00,DEB,DELIVEROOCOUK,23.2,,18312.83,Dine Out,,
4513,2018-01-02 00:00:00,DD,PRINCIPALITY BS,957.26,,18336.03,Mortgage,Swansea,UK
4514,2018-01-02 00:00:00,DD,CC SWANSEA C.TAX,580.73,,19293.29,Bills,Swansea,UK
4515,2018-01-02 00:00:00,DD,GOOD ENERGY LTD,85.0,,19874.02,Bills,Swansea,UK
4516,2018-01-02 00:00:00,DD,AVIVA LIFE,46.46,,19959.02,Insurance,Swansea,UK
4517,2018-01-02 00:00:00,DD,DWR CYMRU W WATER,33.5,,20005.48,Bills,Swansea,UK
4518,2018-01-02 00:00:00,DD,ZURICH,19.36,,20038.98,Insurance,Swansea,UK
4519,2018-01-02 00:00:00,SO,ESAVINGS ACCOUNT,300.0,,20058.34,Savings,Swansea,UK
4520,2018-01-02 00:00:00,BP,SAVE THE CHANGE,0.01,,20358.34,Savings,Swansea,UK
4521,31/01/2018,DEB,AMAZON SVCS EU-UK,19.99,,20358.35,Amazon,Swansea,UK
4522,31/01/2018,DD,UCU B ACCOUNT,23.11,,20378.34,Others,Swansea,UK
4523,31/01/2018,BP,SAVE THE CHANGE,1.1,,20401.45,Savings,Swansea,UK
4524,31/01/2018,BGC,SWANSEA UNI - PAY,,3180.98,20402.55,Paycheck,Swansea,UK
4525,30/01/2018,DEB,GWR WEBSALES,65.4,,17221.57,Travel,,
4526,30/01/2018,DEB,GWR WEBSALES,32.0,,17286.97,Travel,,
4527,30/01/2018,DEB,GWR WEBSALES,12.5,,17318.97,Travel,,
4528,30/01/2018,CPT,LNK UNI - UNIVERSI,100.0,,17331.47,Cash,Swansea,UK
4529,29/01/2018,DEB,AMZ*Amazon.co.uk,,0.94,17431.47,Supplementary Income,Swansea,UK
4530,29/01/2018,BP,SAVE THE CHANGE,1.05,,17430.53,Savings,Swansea,UK
4531,26/01/2018,DEB,Amazon UK Retail,13.6,,17431.58,Amazon,Swansea,UK
4532,26/01/2018,DEB,Amazon UK Marketpl,5.49,,17445.18,Amazon,Swansea,UK
4533,26/01/2018,DEB,Amazon UK Marketpl,2.86,,17450.67,Amazon,Swansea,UK
4534,24/01/2018,BP,SAVE THE CHANGE,1.28,,17453.53,Savings,Swansea,UK
4535,23/01/2018,DEB,JS ONLINE GROCERY,196.22,,17454.81,Groceries,Swansea,UK
4536,23/01/2018,DEB,IKEA ONLINE,124.0,,17651.03,Other Shopping,,
4537,23/01/2018,DEB,ETSY.COM - AURAGRA,20.5,,17775.03,Other Shopping,,
4538,23/01/2018,DEB,JS ONLINE GROCERY,,1.3,17795.53,Supplementary Income,Swansea,UK
4539,23/01/2018,BP,SAVE THE CHANGE,0.86,,17794.23,Savings,Swansea,UK
4540,22/01/2018,DEB,Amazon *Mktplce EU,9.14,,17795.09,Amazon,Swansea,UK
4541,22/01/2018,CPT,LNK UNI - UNIVERSI,50.0,,17804.23,Cash,Swansea,UK
4542,22/01/2018,DD,VIRGIN MEDIA PYMTS,27.0,,17854.23,Bills,Nottingham,UK
4543,19/01/2018,CPT,LNK UNI - UNIVERSI,50.0,,17881.23,Cash,Swansea,UK
4544,17/01/2018,DEB,BIRMINGHAM INT HOT,,28.0,17931.23,Supplementary Income,Swansea,UK
4545,17/01/2018,CPT,LNK UNI - UNIVERSI,40.0,,17903.23,Cash,Swansea,UK
4546,17/01/2018,BP,SAVE THE CHANGE,2.9,,17943.23,Savings,Swansea,UK
4547,16/01/2018,DEB,GWR WEBSALES,148.2,,17946.13,Travel,,
4548,16/01/2018,DEB,QUEENS HOTEL,87.3,,18094.33,Hotels,Leeds,UK
4549,16/01/2018,DEB,ARRIVA TRAINS WALE,62.4,,18181.63,Travel,Birmingham,UK
4550,16/01/2018,DEB,WEST COAST TRAINS,62.2,,18244.03,Travel,,
4551,16/01/2018,DEB,BIRMINGHAM INT HOT,28.0,,18306.23,Hotels,Birmingham,UK
4552,16/01/2018,DD,O2,17.26,,18334.23,Other Shopping,Swansea,UK
4553,16/01/2018,BP,SAVE THE CHANGE,0.97,,18351.49,Savings,Swansea,UK
4554,15/01/2018,DEB,AMAZON EU AMAZON.C,6.0,,18352.46,Amazon,Swansea,UK
4555,15/01/2018,DEB,AMAZON EU AMAZON.C,6.0,,18358.46,Amazon,Swansea,UK
4556,15/01/2018,DEB,Amazon UK Marketpl,5.82,,18364.46,Amazon,Swansea,UK
4557,15/01/2018,DEB,AMAZON EU AMAZON.C,5.21,,18370.28,Amazon,Swansea,UK
4558,15/01/2018,BP,SAVE THE CHANGE,0.2,,18375.49,Savings,Swansea,UK
4559,2018-12-01 00:00:00,DEB,ARRIVA TRAINS WALE,23.8,,18375.69,Travel,Birmingham,UK
4560,2018-12-01 00:00:00,CPT,LNK UNI - UNIVERSI,50.0,,18399.49,Cash,Swansea,UK
4561,2018-12-01 00:00:00,BP,SAVE THE CHANGE,0.8,,18449.49,Savings,Swansea,UK
4562,2018-11-01 00:00:00,DEB,DELIVEROOCOUK,22.2,,18450.29,Dine Out,Swansea,UK
4563,2018-11-01 00:00:00,CPT,LNK ARRIVA TRAINS,40.0,,18472.49,Cash,Birmingham,UK
4564,2018-11-01 00:00:00,BP,SAVE THE CHANGE,1.62,,18512.49,Savings,Swansea,UK
4565,2018-10-01 00:00:00,DEB,Amazon UK Marketpl,14.99,,18514.11,Amazon,Swansea,UK
4566,2018-10-01 00:00:00,DEB,Amazon UK Marketpl,3.09,,18529.1,Amazon,Swansea,UK
4567,2018-10-01 00:00:00,DEB,Amazon UK Marketpl,1.3,,18532.19,Amazon,Swansea,UK
4568,2018-10-01 00:00:00,DEB,BRITANNIA,28.0,,18533.49,Entertainment,Swansea,UK
4569,2018-09-01 00:00:00,CPT,LNK UNI - UNIVERSI,40.0,,18561.49,Cash,Swansea,UK
4570,2018-09-01 00:00:00,BP,SAVE THE CHANGE,0.03,,18601.49,Savings,Swansea,UK
4571,2018-08-01 00:00:00,DEB,Amazon UK Marketpl,10.98,,18601.52,Amazon,Swansea,UK
4572,2018-08-01 00:00:00,DEB,Amazon UK Marketpl,5.99,,18612.5,Amazon,Swansea,UK
4573,2018-08-01 00:00:00,DD,LV LIFE,37.12,,18618.49,Insurance,Swansea,UK
4574,2018-08-01 00:00:00,BP,SAVE THE CHANGE,1.06,,18655.61,Savings,Swansea,UK
4575,2018-05-01 00:00:00,DEB,Amazon UK Marketpl,29.96,,18656.67,Amazon,Swansea,UK
4576,2018-05-01 00:00:00,DEB,Amazon UK Marketpl,6.94,,18686.63,Amazon,Swansea,UK
4577,2018-05-01 00:00:00,DEB,Amazon UK Marketpl,6.04,,18693.57,Amazon,Swansea,UK
4578,2018-05-01 00:00:00,CPT,LNK UNI - UNIVERSI,50.0,,18699.61,Cash,Swansea,UK
4579,2018-04-01 00:00:00,DD,ZURICH,19.36,,18749.61,Insurance,Swansea,UK
4580,2018-03-01 00:00:00,DD,ASSURANT INTER LTD,21.37,,18768.97,Insurance,Swansea,UK
4581,2018-03-01 00:00:00,BP,SAVE THE CHANGE,1.19,,18790.34,Savings,Swansea,UK
4582,2018-02-01 00:00:00,FEE,ACCOUNT FEE,9.95,,18791.53,Bills,Swansea,UK
4583,2018-02-01 00:00:00,DEB,Amazon UK Marketpl,5.55,,18801.48,Amazon,Swansea,UK
4584,2018-02-01 00:00:00,DEB,Amazon UK Marketpl,6.99,,18807.03,Amazon,Swansea,UK
4585,2018-02-01 00:00:00,DEB,NON-STG PURCH FEE,0.5,,18814.02,Others,Swansea,UK
4586,2018-02-01 00:00:00,DEB,NON-STG TRANS FEE,2.16,,18814.52,Others,Swansea,UK
4587,2018-02-01 00:00:00,DEB,ATHLEAN-X,72.27,,18816.68,Entertainment,Swansea,UK
4588,2018-02-01 00:00:00,DD,PRINCIPALITY BS,957.26,,18888.95,Mortgage,Swansea,UK
4589,2018-02-01 00:00:00,DD,GOOD ENERGY LTD,85.0,,19846.21,Bills,Swansea,UK
4590,2018-02-01 00:00:00,DD,AVIVA LIFE,46.46,,19931.21,Insurance,Swansea,UK
4591,2018-02-01 00:00:00,DD,DWR CYMRU W WATER,33.5,,19977.67,Bills,Swansea,UK
4592,2018-02-01 00:00:00,SO,ESAVINGS ACCOUNT,300.0,,20011.17,Savings,Swansea,UK
4593,2018-02-01 00:00:00,BP,SAVE THE CHANGE,0.98,,20311.17,Savings,Swansea,UK
4594,2018-02-01 00:00:00,DEB,NON-STG PURCH FEE,0.5,,20312.15,Others,Swansea,UK
4595,2018-02-01 00:00:00,DEB,NON-STG TRANS FEE,0.95,,20312.65,Others,Swansea,UK
4596,2018-02-01 00:00:00,DEB,REST JARDIM DAS CE,32.02,,20313.6,Dine Out,Lisbon,Portugal
4597,29/12/2017,DD,UCU B ACCOUNT,23.11,,20345.62,Others,Swansea,UK
4598,29/12/2017,BP,SAVE THE CHANGE,0.06,,20368.73,Savings,Swansea,UK
4599,28/12/2017,DEB,FOREIGN CASH FEE,1.5,,20368.79,Travel,Setubal,Portugal
4600,28/12/2017,DEB,Alegro Setubal-P1,96.75,,20370.29,Other Shopping,Setubal,Portugal
4601,28/12/2017,DEB,AMAZON MKTPLACE PM,17.94,,20467.04,Amazon,Swansea,UK
4602,27/12/2017,BP,SAVE THE CHANGE,0.47,,20484.98,Savings,Swansea,UK
4603,22/12/2017,DEB,NON-STG PURCH FEE,0.5,,20485.45,Others,Swansea,UK
4604,22/12/2017,DEB,NON-STG TRANS FEE,1.54,,20485.95,Others,Swansea,UK
4605,22/12/2017,DEB,JUMBO SETUBAL,51.53,,20487.49,Other Shopping,Setubal,Portugal
4606,22/12/2017,BP,SAVE THE CHANGE,0.62,,20539.02,Savings,Swansea,UK
4607,21/12/2017,DEB,AMAZON MKTPLACE PM,17.94,,20539.64,Amazon,Swansea,UK
4608,21/12/2017,DEB,GODADDY COM EUROPE,31.44,,20557.58,Others,Swansea,UK
4609,21/12/2017,DD,VIRGIN MEDIA PYMTS,27.0,,20589.02,Bills,Nottingham,UK
4610,21/12/2017,BP,SAVE THE CHANGE,0.26,,20616.02,Savings,Swansea,UK
4611,20/12/2017,DEB,ARRIVA TRAINS WALE,73.8,,20616.28,Travel,Setubal,Portugal
4612,20/12/2017,DEB,AMAZON MKTPLACE PM,17.94,,20690.08,Amazon,Swansea,UK
4613,20/12/2017,BP,SAVE THE CHANGE,0.62,,20708.02,Savings,Swansea,UK
4614,20/12/2017,BGC,SWANSEA UNI - PAY,,3180.97,20708.64,Paycheck,Swansea,UK
4615,19/12/2017,DEB,Amazon UK Marketpl,4.38,,17527.67,Amazon,Swansea,UK
4616,19/12/2017,BP,SAVE THE CHANGE,0.72,,17532.05,Savings,Swansea,UK
4617,18/12/2017,DEB,GWR WEBSALES,269.3,,17532.77,Travel,Setubal,Portugal
4618,18/12/2017,DEB,AMAZON EU AMAZON.C,23.99,,17802.07,Amazon,Swansea,UK
4619,18/12/2017,DEB,Amazon UK Marketpl,16.99,,17826.06,Amazon,Swansea,UK
4620,18/12/2017,CPT,LNK CAMBRIDGE STAT,50.0,,17843.05,Cash,Cambridge,UK
4621,18/12/2017,DD,O2,30.69,,17893.05,Other Shopping,Swansea,UK
4622,18/12/2017,BP,SAVE THE CHANGE,1.26,,17923.74,Savings,Swansea,UK
4623,15/12/2017,DEB,Amazon UK Retail,8.0,,17925.0,Amazon,Swansea,UK
4624,15/12/2017,DEB,Amazon UK Marketpl,6.48,,17933.0,Amazon,Swansea,UK
4625,15/12/2017,DEB,Amazon UK Marketpl,4.98,,17939.48,Amazon,Swansea,UK
4626,15/12/2017,DEB,Amazon UK Marketpl,4.28,,17944.46,Amazon,Swansea,UK
4627,15/12/2017,CPT,LNK 37 THE QUADANT,96.15,,17948.74,Cash,Swansea,UK
4628,15/12/2017,BP,SAVE THE CHANGE,0.8,,18044.89,Savings,Swansea,UK
4629,14/12/2017,DEB,DELIVEROOCOUK,20.2,,18045.69,Dine Out,,
4630,14/12/2017,CPT,LNK UNI - UNIVERSI,50.0,,18065.89,Cash,Swansea,UK
4631,14/12/2017,BP,SAVE THE CHANGE,0.36,,18115.89,Savings,Swansea,UK
4632,13/12/2017,DEB,Amazon UK Retail,20.64,,18116.25,Amazon,Swansea,UK
4633,2017-12-12 00:00:00,CPT,LNK UNI - UNIVERSI,100.0,,18136.89,Cash,Swansea,UK
4634,2017-11-12 00:00:00,BP,SAVE THE CHANGE,0.11,,18236.89,Savings,Swansea,UK
4635,2017-11-12 00:00:00,CPT,LNK UNI - UNIVERSI,50.0,,18237.0,Cash,Swansea,UK
4636,2017-08-12 00:00:00,DEB,Amazon UK Marketpl,12.94,,18287.0,Amazon,Swansea,UK
4637,2017-08-12 00:00:00,DEB,Amazon UK Marketpl,9.95,,18299.94,Amazon,Swansea,UK
4638,2017-08-12 00:00:00,CPT,LNK UNI - UNIVERSI,50.0,,18309.89,Cash,Swansea,UK
4639,2017-08-12 00:00:00,DD,LV LIFE,37.12,,18359.89,Insurance,Swansea,UK
4640,2017-08-12 00:00:00,BP,SAVE THE CHANGE,1.19,,18397.01,Insurance,Swansea,UK
4641,2017-08-12 00:00:00,BGC,SWANSEA UNIVERSITY,,192.05,18398.2,Supplementary Income,Swansea,UK
4642,2017-07-12 00:00:00,DEB,Amazon UK Retail,18.6,,18206.15,Amazon,Swansea,UK
4643,2017-07-12 00:00:00,DEB,Amazon UK Marketpl,18.21,,18224.75,Amazon,Swansea,UK
4644,2017-05-12 00:00:00,CPT,LNK UNI - UNIVERSI,50.0,,18242.96,Cash,Swansea,UK
4645,2017-05-12 00:00:00,DD,ASSURANT INTER LTD,21.37,,18292.96,Insurance,Swansea,UK
4646,2017-05-12 00:00:00,BP,SAVE THE CHANGE,0.94,,18314.33,Savings,Swansea,UK
4647,2017-04-12 00:00:00,DEB,Amazon UK Marketpl,11.39,,18315.27,Amazon,Swansea,UK
4648,2017-04-12 00:00:00,DEB,Amazon UK Marketpl,9.67,,18326.66,Amazon,Swansea,UK
4649,2017-04-12 00:00:00,CPT,LNK UNI - UNIVERSI,50.0,,18336.33,Cash,Swansea,UK
4650,2017-04-12 00:00:00,BP,SAVE THE CHANGE,0.21,,18386.33,Savings,Swansea,UK
4651,2017-01-12 00:00:00,FEE,ACCOUNT FEE,9.95,,18386.54,Bills,Swansea,UK
4652,2017-01-12 00:00:00,DEB,FUNKY FUTON CO LTD,483.0,,18396.49,Home Improvement,Swansea,UK
4653,2017-01-12 00:00:00,DEB,Amazon UK Retail,11.79,,18879.49,Amazon,Swansea,UK
4654,2017-01-12 00:00:00,DD,PRINCIPALITY BS,957.26,,18891.28,Mortgage,Swansea,UK
4655,2017-01-12 00:00:00,DD,GOOD ENERGY LTD,85.0,,19848.54,Bills,Swansea,UK
4656,2017-01-12 00:00:00,DD,AVIVA LIFE,46.46,,19933.54,Insurance,Swansea,UK
4657,2017-01-12 00:00:00,DD,DWR CYMRU W WATER,33.5,,19980.0,Bills,Swansea,UK
4658,2017-01-12 00:00:00,DD,ZURICH,19.36,,20013.5,Insurance,Swansea,UK
4659,2017-01-12 00:00:00,SO,ESAVINGS ACCOUNT,300.0,,20032.86,Savings,Swansea,UK
4660,30/11/2017,DD,UCU B ACCOUNT,23.11,,20332.86,Others,Swansea,UK
4661,30/11/2017,BGC,SWANSEA UNI - PAY,,3180.97,20355.97,Paycheck,Swansea,UK
4662,30/11/2017,BGC,C C SWANSEA,,638.73,17175.0,Supplementary Income,Swansea,UK
4663,29/11/2017,BP,SAVE THE CHANGE,0.55,,16536.27,Savings,Swansea,UK
4664,28/11/2017,DEB,Amazon UK Marketpl,1.45,,16536.82,Amazon,Swansea,UK
4665,28/11/2017,BP,SAVE THE CHANGE,0.75,,16538.27,Savings,Swansea,UK
4666,27/11/2017,DEB,AMAZON UK RETAIL A,14.25,,16539.02,Amazon,Swansea,UK
4667,22/11/2017,BGC,MIDDLESEX UNIV.,,217.99,16553.27,Supplementary Income,Swansea,UK
4668,21/11/2017,CPT,LNK UNI - UNIVERSI,50.0,,16335.28,Cash,Swansea,UK
4669,21/11/2017,DD,VIRGIN MEDIA PYMTS,27.0,,16385.28,Bills,Nottingham,UK
4670,21/11/2017,BP,SAVE THE CHANGE,2.05,,16412.28,Savings,Swansea,UK
4671,20/11/2017,DEB,MOUNTAIN WAREHOUSE,34.99,,16414.33,Other Shopping,Leicester,UK
4672,20/11/2017,DEB,WAGAMAMA CARDIFF L,28.45,,16449.32,Dine Out,Cardiff,UK
4673,20/11/2017,DEB,AMAZON SVCS EU-UK,18.82,,16477.77,Amazon,Swansea,UK
4674,20/11/2017,DEB,Amazon UK Retail,16.76,,16496.59,Amazon,Swansea,UK
4675,20/11/2017,DEB,T K MAXX,12.97,,16513.35,Other Shopping,,
4676,20/11/2017,DEB,ODEON/BOOKIT,24.0,,16526.32,Entertainment,,
4677,20/11/2017,DEB,Amazon UK Marketpl,18.71,,16550.32,Amazon,Swansea,UK
4678,20/11/2017,DEB,AMAZON EU AMAZON.C,13.92,,16569.03,Amazon,Swansea,UK
4679,20/11/2017,DEB,Amazon UK Marketpl,5.35,,16582.95,Amazon,Swansea,UK
4680,20/11/2017,DEB,Amazon UK Marketpl,4.98,,16588.3,Amazon,Swansea,UK
4681,20/11/2017,BP,SAVE THE CHANGE,0.33,,16593.28,Savings,Swansea,UK
4682,17/11/2017,DEB,Amazon UK Marketpl,19.97,,16593.61,Amazon,Swansea,UK
4683,17/11/2017,DEB,DELIVEROOCOUK,22.7,,16613.58,Dine Out,,
4684,17/11/2017,CPT,LNK UNI - UNIVERSI,50.0,,16636.28,Cash,Swansea,UK
4685,16/11/2017,DD,O2,27.45,,16686.28,Other Shopping,Swansea,UK
4686,15/11/2017,BP,SAVE THE CHANGE,0.01,,16713.73,Savings,Swansea,UK
4687,14/11/2017,DEB,Amazon UK Marketpl,7.99,,16713.74,Amazon,Swansea,UK
4688,14/11/2017,BP,SAVE THE CHANGE,0.99,,16721.73,Savings,Swansea,UK
4689,13/11/2017,DEB,w1185123616,94.01,,16722.72,Others,Swansea,UK
4690,13/11/2017,BP,SAVE THE CHANGE,0.3,,16816.73,Savings,Swansea,UK
4691,2017-10-11 00:00:00,DEB,DELIVEROOCOUK,21.7,,16817.03,Dine Out,,
4692,2017-10-11 00:00:00,BP,SAVE THE CHANGE,0.38,,16838.73,Savings,Swansea,UK
4693,2017-09-11 00:00:00,DEB,AMAZON SVCS EU-UK,14.62,,16839.11,Amazon,Swansea,UK
4694,2017-09-11 00:00:00,BP,SAVE THE CHANGE,0.96,,16853.73,Savings,Swansea,UK
4695,2017-08-11 00:00:00,DEB,AMAZON SVCS EU-UK,29.05,,16854.69,Amazon,Swansea,UK
4696,2017-08-11 00:00:00,DEB,AMAZON SVCS EU-UK,16.99,,16883.74,Amazon,Swansea,UK
4697,2017-08-11 00:00:00,CPT,LNK UNI - UNIVERSI,50.0,,16900.73,Cash,Swansea,UK
4698,2017-08-11 00:00:00,DD,LV LIFE,37.12,,16950.73,Insurance,Swansea,UK
4699,2017-08-11 00:00:00,BP,SAVE THE CHANGE,0.31,,16987.85,Savings,Swansea,UK
4700,2017-07-11 00:00:00,DEB,AMAZON SVCS EU-UK,13.69,,16988.16,Amazon,Swansea,UK
4701,2017-07-11 00:00:00,BP,SAVE THE CHANGE,0.28,,17001.85,Savings,Swansea,UK
4702,2017-06-11 00:00:00,DEB,AMAZON SVCS EU-UK,21.98,,17002.13,Amazon,Swansea,UK
4703,2017-06-11 00:00:00,DEB,GWR LON PADD TO,26.9,,17024.11,Travel,London,UK
4704,2017-06-11 00:00:00,DEB,LUL TICKET MACHINE,4.9,,17051.01,Travel,London,UK
4705,2017-06-11 00:00:00,DEB,AMAZON SVCS EU-UK,2.95,,17055.91,Amazon,Swansea,UK
4706,2017-06-11 00:00:00,DEB,AMAZON SVCS EU-UK,14.99,,17058.86,Amazon,Swansea,UK
4707,2017-06-11 00:00:00,CPT,LNK UNI - UNIVERSI,60.0,,17073.85,Cash,Swansea,UK
4708,2017-06-11 00:00:00,BP,SAVE THE CHANGE,0.01,,17133.85,Savings,Swansea,UK
4709,2017-03-11 00:00:00,DEB,AMAZON SVCS EU-UK,6.99,,17133.86,Amazon,Swansea,UK
4710,2017-03-11 00:00:00,DD,ASSURANT INTER LTD,21.37,,17140.85,Insurance,Swansea,UK
4711,2017-03-11 00:00:00,BGC,SWANSEA UNIVERSITY,,1554.87,17162.22,Supplementary Income,Swansea,UK
4712,2017-01-11 00:00:00,FEE,ACCOUNT FEE,9.95,,15607.35,Bills,Swansea,UK
4713,2017-01-11 00:00:00,DD,PRINCIPALITY BS,957.26,,15617.3,Mortgage,Swansea,UK
4714,2017-01-11 00:00:00,DD,AVIVA LIFE,46.46,,16574.56,Insurance,Swansea,UK
4715,2017-01-11 00:00:00,DD,DWR CYMRU W WATER,33.5,,16621.02,Bills,Swansea,UK
4716,2017-01-11 00:00:00,DD,ZURICH,19.36,,16654.52,Insurance,Swansea,UK
4717,2017-01-11 00:00:00,SO,ESAVINGS ACCOUNT,300.0,,16673.88,Savings,Swansea,UK
4718,2017-01-11 00:00:00,BP,SAVE THE CHANGE,0.01,,16973.88,Savings,Swansea,UK
4719,31/10/2017,DEB,Amazon UK Marketpl,7.99,,16973.89,Amazon,Swansea,UK
4720,31/10/2017,DD,UCU B ACCOUNT,23.11,,16981.88,Others,Swansea,UK
4721,31/10/2017,BP,SAVE THE CHANGE,2.73,,17004.99,Savings,Swansea,UK
4722,31/10/2017,BGC,SWANSEA UNI - PAY,,3180.98,17007.72,Paycheck,Swansea,UK
4723,30/10/2017,DEB,Amazon UK Marketpl,7.1,,13826.74,Amazon,Swansea,UK
4724,30/10/2017,DEB,AMAZON.CO.UK,5.74,,13833.84,Amazon,Swansea,UK
4725,30/10/2017,DEB,JS ONLINE GROCERY,244.2,,13839.58,Groceries,Swansea,UK
4726,30/10/2017,DEB,WWW.GOODENERGY.CO.,145.23,,14083.78,Bills,Nottingham,UK
4727,30/10/2017,BP,SAVE THE CHANGE,0.95,,14229.01,Savings,Swansea,UK
4728,27/10/2017,DEB,DELIVEROOCOUK,20.05,,14229.96,Dine Out,,
4729,27/10/2017,CPT,LNK UNI - UNIVERSI,60.0,,14250.01,Cash,Swansea,UK
4730,27/10/2017,BGC,SWANSEA UNIVERSITY,,1245.34,14310.01,Supplementary Income,Swansea,UK
4731,27/10/2017,BGC,MIDDLESEX UNIV,,140.0,13064.67,Supplementary Income,Swansea,UK
4732,25/10/2017,BP,SAVE THE CHANGE,0.35,,12924.67,Savings,Swansea,UK
4733,24/10/2017,DEB,AMAZON SVCS EU-UK,4.65,,12925.02,Amazon,Swansea,UK
4734,24/10/2017,CPT,LNK UNI - UNIVERSI,50.0,,12929.67,Cash,Swansea,UK
4735,24/10/2017,BP,SAVE THE CHANGE,1.35,,12979.67,Savings,Swansea,UK
4736,23/10/2017,DEB,IKEA ONLINE,75.4,,12981.02,Other Shopping,,
4737,23/10/2017,DEB,AMAZON SVCS EU-UK,2.85,,13056.42,Amazon,Swansea,UK
4738,23/10/2017,DEB,AMAZON EU AMAZON.C,15.4,,13059.27,Amazon,Swansea,UK
4739,23/10/2017,DD,VIRGIN MEDIA PYMTS,49.0,,13074.67,Bills,Nottingham,UK
4740,23/10/2017,BP,SAVE THE CHANGE,1.03,,13123.67,Savings,Swansea,UK
4741,20/10/2017,DEB,Amazon UK Marketpl,15.77,,13124.7,Amazon,Swansea,UK
4742,20/10/2017,DEB,DELIVEROOCOUK,19.2,,13140.47,Dine Out,,
4743,20/10/2017,CPT,LNK UNI - UNIVERSI,50.0,,13159.67,Cash,Swansea,UK
4744,20/10/2017,BP,SAVE THE CHANGE,0.08,,13209.67,Savings,Swansea,UK
4745,19/10/2017,DEB,Amazon UK Marketpl,14.93,,13209.75,Amazon,Swansea,UK
4746,19/10/2017,DEB,Amazon UK Marketpl,5.99,,13224.68,Amazon,Swansea,UK
4747,19/10/2017,BP,SAVE THE CHANGE,0.53,,13230.67,Savings,Swansea,UK
4748,18/10/2017,DEB,Amazon UK Retail,7.49,,13231.2,Amazon,Swansea,UK
4749,18/10/2017,DEB,Amazon UK Marketpl,2.98,,13238.69,Amazon,Swansea,UK
4750,18/10/2017,DD,ZURICH,19.36,,13241.67,Insurance,,
4751,17/10/2017,CPT,LNK UNI - UNIVERSI,40.0,,13261.03,Cash,Swansea,UK
4752,17/10/2017,BP,SAVE THE CHANGE,0.23,,13301.03,Savings,Swansea,UK
4753,16/10/2017,DEB,Amazon UK Marketpl,7.77,,13301.26,Amazon,Swansea,UK
4754,16/10/2017,DD,O2,17.26,,13309.03,Other Shopping,Swansea,UK
4755,16/10/2017,BP,SAVE THE CHANGE,0.8,,13326.29,Savings,Swansea,UK
4756,13/10/2017,DEB,DELIVEROOCOUK,20.2,,13327.09,Dine Out,,
4757,13/10/2017,CPT,LNK UNI - UNIVERSI,20.0,,13347.29,Cash,Swansea,UK
4758,13/10/2017,BP,SAVE THE CHANGE,0.05,,13367.29,Savings,Swansea,UK
4759,2017-12-10 00:00:00,DEB,Amazon UK Retail,31.95,,13367.34,Amazon,Swansea,UK
4760,2017-12-10 00:00:00,BP,SAVE THE CHANGE,1.33,,13399.29,Savings,Swansea,UK
4761,2017-11-10 00:00:00,DEB,Amazon UK Retail,14.99,,13400.62,Amazon,Swansea,UK
4762,2017-11-10 00:00:00,DEB,AMAZON.CO.UK,6.19,,13415.61,Amazon,Swansea,UK
4763,2017-11-10 00:00:00,DEB,AMAZON.CO.UK,4.49,,13421.8,Amazon,Swansea,UK
4764,2017-11-10 00:00:00,CHQ,LOYD 802 OXFORD ST,,383.47,13426.29,Supplementary Income,Swansea,UK
4765,2017-11-10 00:00:00,BP,SAVE THE CHANGE,0.87,,13042.82,Savings,Swansea,UK
4766,2017-10-10 00:00:00,DEB,Amazon UK Marketpl,4.38,,13043.69,Amazon,Swansea,UK
4767,2017-10-10 00:00:00,CPT,LNK UNI - UNIVERSI,50.0,,13048.07,Cash,Swansea,UK
4768,2017-10-10 00:00:00,DEB,NON-STG PURCH FEE,0.5,,13098.07,Others,Swansea,UK
4769,2017-10-10 00:00:00,DEB,NON-STG TRANS FEE,32.4,,13098.57,Others,Swansea,UK
4770,2017-10-10 00:00:00,DEB,HYATT REGENCY PHOE,1083.75,,13130.97,Hotels,Phoenix,USA
4771,2017-09-10 00:00:00,DD,LV LIFE,37.12,,14214.72,Insurance,Swansea,UK
4772,2017-03-10 00:00:00,FPI,MARIANA MILLS,,200.0,14251.84,Supplementary Income,Swansea,UK
4773,2017-03-10 00:00:00,DD,ASSURANT INTER LTD,21.37,,14051.84,Insurance,Swansea,UK
4774,2017-02-10 00:00:00,FEE,ACCOUNT FEE,9.95,,14073.21,Bills,Swansea,UK
4775,2017-02-10 00:00:00,DD,PRINCIPALITY BS,957.26,,14083.16,Mortgage,Swansea,UK
4776,2017-02-10 00:00:00,DD,CC SWANSEA C.TAX,174.0,,15040.42,Bills,Swansea,UK
4777,2017-02-10 00:00:00,DD,AVIVA LIFE,46.46,,15214.42,Insurance,Swansea,UK
4778,2017-02-10 00:00:00,DD,DWR CYMRU W WATER,33.5,,15260.88,Bills,Swansea,UK
4779,2017-02-10 00:00:00,SO,ESAVINGS ACCOUNT,300.0,,15294.38,Savings,Swansea,UK
4780,29/09/2017,CPT,LNK UNI - UNIVERSI,150.0,,15594.38,Cash,Swansea,UK
4781,29/09/2017,DD,UCU B ACCOUNT,23.11,,15744.38,Others,Swansea,UK
4782,29/09/2017,BP,SAVE THE CHANGE,2.27,,15767.49,Savings,Swansea,UK
4783,29/09/2017,BGC,SWANSEA UNI - PAY,,3180.97,15769.76,Paycheck,Swansea,UK
4784,28/09/2017,DEB,ARRIVA TRAINS WALE,95.3,,12588.79,Travel,,
4785,28/09/2017,DEB,BIRMINGHAM INT HOT,91.5,,12684.09,Hotels,Birmingham,UK
4786,28/09/2017,DEB,WASABI BIRMINGHAM,28.0,,12775.59,Dine Out,Birmingham,UK
4787,28/09/2017,DEB,Amazon UK Marketpl,17.65,,12803.59,Amazon,Swansea,UK
4788,28/09/2017,DEB,AMAZON UK RETAIL A,12.99,,12821.24,Amazon,Swansea,UK
4789,28/09/2017,DEB,NON-STG PURCH FEE,0.5,,12834.23,Others,Swansea,UK
4790,28/09/2017,DEB,NON-STG TRANS FEE,1.11,,12834.73,Others,Swansea,UK
4791,28/09/2017,DEB,WPY*Klaus Mueller,37.29,,12835.84,Services,Swansea,UK
4792,27/09/2017,BP,SAVE THE CHANGE,2.1,,12873.13,Savings,Swansea,UK
4793,26/09/2017,DEB,ARRIVA TRAINS WALE,8.4,,12875.23,Travel,,
4794,26/09/2017,DEB,Amazon UK Marketpl,6.01,,12883.63,Amazon,Swansea,UK
4795,26/09/2017,DEB,Amazon UK Marketpl,4.99,,12889.64,Amazon,Swansea,UK
4796,26/09/2017,DEB,Amazon UK Marketpl,2.99,,12894.63,Amazon,Swansea,UK
4797,26/09/2017,DEB,Amazon UK Marketpl,2.51,,12897.62,Amazon,Swansea,UK
4798,25/09/2017,FPI,MARIANA MILLS,,180.0,12900.13,Supplementary Income,Swansea,UK
4799,25/09/2017,CPT,LNK UNI - UNIVERSI,100.0,,12720.13,Cash,Swansea,UK
4800,25/09/2017,BP,SAVE THE CHANGE,0.86,,12820.13,Savings,Swansea,UK
4801,22/09/2017,DEB,EASYJET   ESVS7J,380.94,,12820.99,Travel,,
4802,22/09/2017,DEB,Amazon UK Marketpl,2.0,,13201.93,Amazon,Swansea,UK
4803,22/09/2017,DEB,DELIVEROOCOUK,20.2,,13203.93,Dine Out,,
4804,22/09/2017,CPT,LNK UNI - UNIVERSI,50.0,,13224.13,Cash,Swansea,UK
4805,22/09/2017,BP,SAVE THE CHANGE,1.08,,13274.13,Savings,Swansea,UK
4806,21/09/2017,DEB,WATSON & PRATTS,140.67,,13275.21,Groceries ,Lampeter,UK
4807,21/09/2017,DEB,Amazon UK Marketpl,6.25,,13415.88,Amazon,Swansea,UK
4808,21/09/2017,BP,SAVE THE CHANGE,0.01,,13422.13,Savings,Swansea,UK
4809,20/09/2017,DEB,Amazon UK Retail,12.99,,13422.14,Amazon,Swansea,UK
4810,19/09/2017,CPT,LNK UNI - UNIVERSI,50.0,,13435.13,Cash,Swansea,UK
4811,19/09/2017,BP,SAVE THE CHANGE,0.5,,13485.13,Savings,Swansea,UK
4812,18/09/2017,DEB,BIRMINGHAM INT HOT,47.5,,13485.63,Hotels,Birmingham,UK
4813,18/09/2017,DD,O2,29.36,,13533.13,Other Shopping,Swansea,UK
4814,18/09/2017,CPT,LNK ARRIVA TRAINS,50.0,,13562.49,Cash,,
4815,14/09/2017,DEB,ARRIVA TRAINS WALE,89.0,,13612.49,Travel,,
4816,13/09/2017,BP,SAVE THE CHANGE,0.52,,13701.49,Savings,Swansea,UK
4817,2017-12-09 00:00:00,DEB,Amazon UK Marketpl,1.48,,13702.01,Amazon,Swansea,UK
4818,2017-12-09 00:00:00,CPT,LNK UNI - UNIVERSI,50.0,,13703.49,Cash,Swansea,UK
4819,2017-12-09 00:00:00,BP,SAVE THE CHANGE,0.2,,13753.49,Savings,Swansea,UK
4820,2017-11-09 00:00:00,DEB,IZ *Brontosaurus V,31.8,,13753.69,Dine Out,,
4821,2017-11-09 00:00:00,CPT,LNK UNI - UNIVERSI,50.0,,13785.49,Cash,Swansea,UK
4822,2017-11-09 00:00:00,BP,SAVE THE CHANGE,1.2,,13835.49,Savings,Swansea,UK
4823,2017-11-09 00:00:00,TFR,SERGEJS KATACINS,35.0,,13836.69,Services,Swansea,UK
4824,2017-08-09 00:00:00,DEB,PLUSNET PLC 0845 1,41.6,,13871.69,Entertainment,Swansea,UK
4825,2017-08-09 00:00:00,DEB,DELIVEROOCOUK,19.2,,13913.29,Dine Out,,
4826,2017-08-09 00:00:00,DD,LV LIFE,37.12,,13932.49,Insurance,Swansea,UK
4827,2017-08-09 00:00:00,BP,SAVE THE CHANGE,0.99,,13969.61,Savings,Swansea,UK
4828,2017-07-09 00:00:00,DEB,BRITISH GAS TRADIN,83.66,,13970.6,Home Improvement,Swansea,UK
4829,2017-07-09 00:00:00,DEB,BRITISH GAS TRADIN,49.35,,14054.26,Home Improvement,Swansea,UK
4830,2017-06-09 00:00:00,BP,SAVE THE CHANGE,0.64,,14103.61,Savings,Swansea,UK
4831,2017-05-09 00:00:00,CPT,LNK SWANSEA WIND S,200.0,,14104.25,Cash,Swansea,UK
4832,2017-05-09 00:00:00,DEB,Amazon UK Marketpl,26.87,,14304.25,Amazon,Swansea,UK
4833,2017-05-09 00:00:00,DEB,Amazon UK Marketpl,2.49,,14331.12,Amazon,Swansea,UK
4834,2017-05-09 00:00:00,BP,SAVE THE CHANGE,2.77,,14333.61,Savings,Swansea,UK
4835,2017-04-09 00:00:00,CPT,LNK 1 UNION STREET,100.0,,14336.38,Cash,Leicester,UK
4836,2017-04-09 00:00:00,DEB,Amazon UK Marketpl,63.13,,14436.38,Amazon,Swansea,UK
4837,2017-04-09 00:00:00,DEB,Amazon UK Marketpl,10.14,,14499.51,Amazon,Swansea,UK
4838,2017-04-09 00:00:00,DEB,Amazon UK Retail,4.62,,14509.65,Amazon,Swansea,UK
4839,2017-04-09 00:00:00,DEB,TICKETS08712200260,95.34,,14514.27,Travel,,
4840,2017-04-09 00:00:00,DEB,HENDON HALL HOTEL,114.0,,14609.61,Hotels,London,UK
4841,2017-04-09 00:00:00,DD,ASSURANT INTER LTD,21.47,,14723.61,Insurance,Swansea,UK
4842,2017-04-09 00:00:00,BP,SAVE THE CHANGE,0.7,,14745.08,Savings,Swansea,UK
4843,2017-04-09 00:00:00,TFR,SERGEJS KATACINS,182.0,,14745.78,Services,Swansea,UK
4844,2017-01-09 00:00:00,FEE,ACCOUNT FEE,9.95,,14927.78,Bills,Swansea,UK
4845,2017-01-09 00:00:00,DEB,ARRIVA TRAINS WALE,82.3,,14937.73,Travel,,
4846,2017-01-09 00:00:00,DD,PRINCIPALITY BS,957.26,,15020.03,Mortgage,Swansea,UK
4847,2017-01-09 00:00:00,DD,CC SWANSEA C.TAX,174.0,,15977.29,Bills,Swansea,UK
4848,2017-01-09 00:00:00,DD,AVIVA LIFE,46.46,,16151.29,Insurance,Swansea,UK
4849,2017-01-09 00:00:00,DD,DWR CYMRU W WATER,33.5,,16197.75,Bills,Swansea,UK
4850,2017-01-09 00:00:00,SO,ESAVINGS ACCOUNT,300.0,,16231.25,Savings,Swansea,UK
4851,31/08/2017,CPT,LNK UNI - UNIVERSI,50.0,,16531.25,Cash,Swansea,UK
4852,31/08/2017,DD,UCU B ACCOUNT,22.7,,16581.25,Others,Swansea,UK
4853,31/08/2017,BP,SAVE THE CHANGE,0.41,,16603.95,Savings,Swansea,UK
4854,31/08/2017,BGC,SWANSEA UNI - PAY,,3180.97,16604.36,Paycheck,Swansea,UK
4855,30/08/2017,DEB,Amazon UK Marketpl,18.59,,13423.39,Amazon,Swansea,UK
4856,30/08/2017,BP,SAVE THE CHANGE,0.24,,13441.98,Savings,Swansea,UK
4857,29/08/2017,DEB,Amazon UK Retail,23.76,,13442.22,Amazon,Swansea,UK
4858,29/08/2017,DEB,PLUSNET PLC 0845 1,,5.07,13465.98,Supplementary Income,Swansea,UK
4859,29/08/2017,CPT,LNK UNI - UNIVERSI,50.0,,13460.91,Cash,Swansea,UK
4860,25/08/2017,DEB,VIRGIN MEDIA PYMTS,25.0,,13510.91,Bills,Nottingham,UK
4861,25/08/2017,BP,SAVE THE CHANGE,0.15,,13535.91,Savings,Swansea,UK
4862,24/08/2017,DEB,4500 MILES,28.85,,13536.06,Dine Out,,
4863,24/08/2017,BGC,PLUSNET PLC PAY AC,,9.0,13564.91,Supplementary Income,Swansea,UK
4864,23/08/2017,CPT,LNK TESCO BLEN CRT,30.0,,13555.91,Cash,Bristol,
4865,23/08/2017,BP,SAVE THE CHANGE,0.1,,13585.91,Savings,Swansea,UK
4866,22/08/2017,DEB,THE LANGLEY ARMS,150.0,,13586.01,Travel,,
4867,22/08/2017,DEB,ARRIVA TRAINS WALE,36.9,,13736.01,Travel,,
4868,21/08/2017,CPT,LNK ARRIVA TRAINS,60.0,,13772.91,Cash,,
4869,21/08/2017,DEB,IKEA ONLINE,194.0,,13832.91,Other Shopping,,
4870,21/08/2017,DEB,AMZ*Globoshop,,48.99,14026.91,Supplementary Income,Swansea,UK
4871,18/08/2017,CPT,LNK UNI - UNIVERSI,50.0,,13977.92,Cash,Swansea,UK
4872,17/08/2017,CPT,LNK ARRIVA TRAINS,60.0,,14027.92,Cash,,
4873,17/08/2017,DD,PNET3444685-1,18.99,,14087.92,Others,Swansea,UK
4874,16/08/2017,CPT,LNK UNI - UNIVERSI,250.0,,14106.91,Cash,Swansea,UK
4875,16/08/2017,DD,O2,24.42,,14356.91,Other Shopping,Swansea,UK
4876,16/08/2017,DD,PNET3444685-1,9.0,,14381.33,Others,Swansea,UK
4877,16/08/2017,BP,SAVE THE CHANGE,0.05,,14390.33,Savings,Swansea,UK
4878,15/08/2017,DEB,AMAZON UK RETAIL A,23.95,,14390.38,Amazon,Swansea,UK
4879,15/08/2017,CPT,LNK UNI - UNIVERSI,80.0,,14414.33,Cash,Swansea,UK
4880,15/08/2017,BP,SAVE THE CHANGE,0.01,,14494.33,Savings,Swansea,UK
4881,14/08/2017,DEB,AMAZON.CO.UK,11.99,,14494.34,Amazon,Swansea,UK
4882,14/08/2017,DEB,BRITANNIA,49.0,,14506.33,Amazon,Swansea,UK
4883,2017-11-08 00:00:00,DEB,AMZ*Discounted Cle,,10.58,14555.33,Supplementary Income,Swansea,UK
4884,2017-11-08 00:00:00,CHQ,52,90.0,,14544.75,Cash,,
4885,2017-11-08 00:00:00,BP,SAVE THE CHANGE,0.04,,14634.75,Savings,Swansea,UK
4886,2017-10-08 00:00:00,CPT,LNK TESCO SWANSEA,60.0,,14634.79,Cash,swansea,UK
4887,2017-10-08 00:00:00,DEB,Amazon UK Retail,15.96,,14694.79,Amazon,Swansea,UK
4888,2017-10-08 00:00:00,BP,SAVE THE CHANGE,0.51,,14710.75,Savings,Swansea,UK
4889,2017-09-08 00:00:00,DEB,Amazon UK Retail,5.49,,14711.26,Amazon,Swansea,UK
4890,2017-09-08 00:00:00,DD,LV LIFE,37.12,,14716.75,Insurance,Swansea,UK
4891,2017-09-08 00:00:00,BP,SAVE THE CHANGE,0.81,,14753.87,Savings,Swansea,UK
4892,2017-08-08 00:00:00,DEB,Amazon UK Marketpl,8.39,,14754.68,Amazon,Swansea,UK
4893,2017-08-08 00:00:00,DEB,THE HEALTH SHOP,38.8,,14763.07,Other Shopping,,
4894,2017-08-08 00:00:00,CPT,LNK UNI - UNIVERSI,50.0,,14801.87,Cash,Swansea,UK
4895,2017-08-08 00:00:00,BP,SAVE THE CHANGE,0.81,,14851.87,Savings,Swansea,UK
4896,2017-07-08 00:00:00,DEB,IZ *Brontosaurus V,16.19,,14852.68,Dine Out,,
4897,2017-07-08 00:00:00,BP,SAVE THE CHANGE,2.57,,14868.87,Savings,Swansea,UK
4898,2017-07-08 00:00:00,DEB,NON-STG PURCH FEE,0.5,,14871.44,Others,Swansea,UK
4899,2017-07-08 00:00:00,DEB,NON-STG TRANS FEE,5.36,,14871.94,Others,Swansea,UK
4900,2017-07-08 00:00:00,DEB,HYATT REGENCY PHOE,179.44,,14877.3,Hotels,Phoenix,USA
4901,2017-04-08 00:00:00,DEB,Amazon UK Marketpl,6.26,,15056.74,Amazon,Swansea,UK
4902,2017-04-08 00:00:00,DEB,Amazon UK Retail,5.46,,15063.0,Amazon,Swansea,UK
4903,2017-04-08 00:00:00,DEB,Amazon UK Marketpl,5.27,,15068.46,Amazon,Swansea,UK
4904,2017-04-08 00:00:00,CPT,LNK UNI - UNIVERSI,50.0,,15073.73,Cash,Swansea,UK
4905,2017-04-08 00:00:00,DD,ASSURANT INTER LTD,39.74,,15123.73,Insurance,Swansea,UK
4906,2017-04-08 00:00:00,BP,SAVE THE CHANGE,0.71,,15163.47,Savings,Swansea,UK
4907,2017-03-08 00:00:00,DEB,THE PRINCIPAL MANC,267.3,,15164.18,Dine Out,Manchester,UK
4908,2017-03-08 00:00:00,DEB,Amazon UK Marketpl,48.99,,15431.48,Amazon,Swansea,UK
4909,2017-03-08 00:00:00,DEB,AMZ*Dealsdirect247,,15.99,15480.47,Supplementary Income,Swansea,UK
4910,2017-03-08 00:00:00,BP,SAVE THE CHANGE,0.9,,15464.48,Savings,Swansea,UK
4911,2017-02-08 00:00:00,DEB,SPRINGFIELD DEVELO,160.0,,15465.38,Home Improvement,Swansea,UK
4912,2017-02-08 00:00:00,DEB,SWANSEA UNI - CATE,3.1,,15625.38,Dine Out,Swansea,UK
4913,2017-02-08 00:00:00,BP,SAVE THE CHANGE,0.4,,15628.48,Savings,Swansea,UK
4914,2017-01-08 00:00:00,FEE,ACCOUNT FEE,9.95,,15628.88,Bills,Swansea,UK
4915,2017-01-08 00:00:00,DEB,GWR WEBSALES,78.6,,15638.83,Travel,,
4916,2017-01-08 00:00:00,CPT,LNK 404331M&S SWAN,80.0,,15717.43,Cash,Swansea,UK
4917,2017-01-08 00:00:00,DD,PRINCIPALITY BS,1159.25,,15797.43,Mortgage,Swansea,UK
4918,2017-01-08 00:00:00,DD,CC SWANSEA C.TAX,174.0,,16956.68,Bills,Swansea,UK
4919,2017-01-08 00:00:00,DD,AVIVA LIFE,46.46,,17130.68,Insurance,Swansea,UK
4920,2017-01-08 00:00:00,DD,DWR CYMRU W WATER,33.5,,17177.14,Bills,Swansea,UK
4921,2017-01-08 00:00:00,SO,ESAVINGS ACCOUNT,300.0,,17210.64,Savings,Swansea,UK
4922,2017-01-08 00:00:00,BP,SAVE THE CHANGE,1.89,,17510.64,Savings,Swansea,UK
4923,31/07/2017,DEB,Amazon UK Marketpl,26.25,,17512.53,Amazon,Swansea,UK
4924,31/07/2017,DEB,Amazon UK Marketpl,1.27,,17538.78,Amazon,Swansea,UK
4925,31/07/2017,DEB,IKEA ONLINE,360.0,,17540.05,Other Shopping,,
4926,31/07/2017,DEB,CITY PLUMBING SUPP,153.59,,17900.05,Home Improvement,Swansea,UK
4927,31/07/2017,DD,UCU B ACCOUNT,22.7,,18053.64,Others,Swansea,UK
4928,31/07/2017,BP,SAVE THE CHANGE,0.82,,18076.34,Savings,Swansea,UK
4929,31/07/2017,BGC,SWANSEA UNI - PAY,,3138.66,18077.16,Paycheck,Swansea,UK
4930,28/07/2017,DEB,AMAZON.CO.UK,11.96,,14938.5,Amazon,Swansea,UK
4931,28/07/2017,DEB,AMAZON UK RETAIL A,7.38,,14950.46,Amazon,Swansea,UK
4932,28/07/2017,DEB,AMAZON.CO.UK,13.84,,14957.84,Amazon,Swansea,UK
4933,28/07/2017,CPT,LNK UNI - UNIVERSI,50.0,,14971.68,Cash,Swansea,UK
4934,25/07/2017,CPT,LNK UNI - UNIVERSI,50.0,,15021.68,Cash,Swansea,UK
4935,21/07/2017,CPT,LNK UNI - UNIVERSI,50.0,,15071.68,Cash,Swansea,UK
4936,21/07/2017,DD,VIRGIN MEDIA PYMTS,30.97,,15121.68,Bills,Nottingham,UK
4937,21/07/2017,BGC,SWANSEA UNIVERSITY,,1004.43,15152.65,Supplementary Income,Swansea,UK
4938,20/07/2017,DD,GOOD ENERGY LTD,124.74,,14148.22,Bills,Nottingham,UK
4939,19/07/2017,CPT,LNK UNI - UNIVERSI,50.0,,14272.96,Cash,Swansea,UK
4940,17/07/2017,DD,O2,26.73,,14322.96,Other Shopping,Swansea,UK
4941,14/07/2017,BP,SAVE THE CHANGE,0.5,,14349.69,Savings,Swansea,UK
4942,13/07/2017,DEB,Amazon UK Marketpl,6.5,,14350.19,Amazon,Swansea,UK
4943,13/07/2017,DD,AVIVA LIFE,46.46,,14356.69,Insurance,Swansea,UK
4944,13/07/2017,BP,SAVE THE CHANGE,0.98,,14403.15,Savings,Swansea,UK
4945,2017-12-07 00:00:00,DEB,Amazon UK Marketpl,10.66,,14404.13,Amazon,Swansea,UK
4946,2017-12-07 00:00:00,DEB,Amazon UK Marketpl,10.36,,14414.79,Amazon,Swansea,UK
4947,2017-12-07 00:00:00,BP,SAVE THE CHANGE,0.44,,14425.15,Savings,Swansea,UK
4948,2017-11-07 00:00:00,DEB,PLUSNET PLC 0845 1,68.98,,14425.59,Entertainment,Swansea,UK
4949,2017-11-07 00:00:00,DEB,Amazon UK Marketpl,10.58,,14494.57,Amazon,Swansea,UK
4950,2017-11-07 00:00:00,BP,SAVE THE CHANGE,1.18,,14505.15,Savings,Swansea,UK
4951,2017-10-07 00:00:00,DEB,Amazon UK Retail,13.66,,14506.33,Entertainment,Swansea,UK
4952,2017-10-07 00:00:00,DEB,Amazon UK Retail,17.84,,14519.99,Amazon,Swansea,UK
4953,2017-10-07 00:00:00,DEB,Amazon UK Marketpl,2.62,,14537.83,Amazon,Swansea,UK
4954,2017-10-07 00:00:00,DEB,Amazon UK Marketpl,1.7,,14540.45,Amazon,Swansea,UK
4955,2017-10-07 00:00:00,DD,LVFS LTD A A/C,37.12,,14542.15,Insurance,Swansea,UK
4956,2017-07-07 00:00:00,CPT,LNK UNI - UNIVERSI,100.0,,14579.27,Cash,Swansea,UK
4957,2017-07-07 00:00:00,CHQ,LOYD 802 OXFORD ST,,1003.79,14679.27,Supplementary Income,Swansea,UK
4958,2017-07-07 00:00:00,BP,SAVE THE CHANGE,0.22,,13675.48,Savings,Swansea,UK
4959,2017-06-07 00:00:00,DEB,Amazon UK Marketpl,16.78,,13675.7,Amazon,Swansea,UK
4960,2017-06-07 00:00:00,TFR,F/FLOW NATWEST BAN,,828.49,13692.48,Supplementary Income,Swansea,UK
4961,2017-06-07 00:00:00,CPT,LNK UNI - UNIVERSI,200.0,,12863.99,Cash,Swansea,UK
4962,2017-06-07 00:00:00,BP,SAVE THE CHANGE,0.56,,13063.99,Savings,Swansea,UK
4963,2017-05-07 00:00:00,DEB,Amazon UK Marketpl,14.44,,13064.55,Amazon,Swansea,UK
4964,2017-05-07 00:00:00,BP,SAVE THE CHANGE,0.01,,13078.99,Savings,Swansea,UK
4965,2017-04-07 00:00:00,DEB,AMAZON.CO.UK,16.99,,13079.0,Amazon,Swansea,UK
4966,2017-04-07 00:00:00,BP,SAVE THE CHANGE,0.76,,13095.99,Savings,Swansea,UK
4967,2017-03-07 00:00:00,FEE,ACCOUNT FEE,9.95,,13096.75,Bills,Swansea,UK
4968,2017-03-07 00:00:00,DEB,Amazon UK Marketpl,20.24,,13106.7,Amazon,Swansea,UK
4969,2017-03-07 00:00:00,DD,NATWEST BANK,828.49,,13126.94,Mortgage,Swansea,UK
4970,2017-03-07 00:00:00,DD,CC SWANSEA C.TAX,174.0,,13955.43,Bills,Swansea,UK
4971,2017-03-07 00:00:00,DD,GOOD ENERGY LTD,85.0,,14129.43,Bills,Swansea,UK
4972,2017-03-07 00:00:00,DD,ASSURANT INTER LTD,39.74,,14214.43,Insurance,Swansea,UK
4973,2017-03-07 00:00:00,DD,DWR CYMRU W WATER,32.5,,14254.17,Bills,Swansea,UK
4974,2017-03-07 00:00:00,DD,TV LICENCE MBP,12.37,,14286.67,Bills,Swansea,UK
4975,2017-03-07 00:00:00,SO,ESAVINGS ACCOUNT,300.0,,14299.04,Savings,Swansea,UK
4976,2017-03-07 00:00:00,BGC,SWANSEA UNIVERSITY,,319.45,14599.04,Supplementary Income,Swansea,UK
4977,30/06/2017,DD,UCU B ACCOUNT,22.7,,14279.59,Others,Swansea,UK
4978,30/06/2017,BP,SAVE THE CHANGE,0.64,,14302.29,Savings,Swansea,UK
4979,30/06/2017,BGC,SWANSEA UNI - PAY,,3138.65,14302.93,Paycheck,Swansea,UK
4980,29/06/2017,CPT,LNK UNI - UNIVERSI,250.0,,11164.28,Cash,Swansea,UK
4981,29/06/2017,DEB,POST OFFICE COUNTE,62.99,,11414.28,Others,Swansea,UK
4982,29/06/2017,DEB,Amazon UK Marketpl,16.99,,11477.27,Amazon,Swansea,UK
4983,29/06/2017,DEB,Amazon UK Marketpl,13.8,,11494.26,Amazon,Swansea,UK
4984,29/06/2017,DEB,Amazon UK Marketpl,5.58,,11508.06,Amazon,Swansea,UK
4985,29/06/2017,FPO,DEZREZ LEGAL LTD,5619.03,,11513.64,Mortgage,Nottingham,UK
4986,29/06/2017,BP,SAVE THE CHANGE,0.86,,17132.67,Savings,Swansea,UK
4987,28/06/2017,DEB,Amazon UK Marketpl,26.15,,17133.53,Amazon,Swansea,UK
4988,28/06/2017,DEB,AMAZON UK RETAIL A,6.99,,17159.68,Amazon,Swansea,UK
4989,28/06/2017,BP,SAVE THE CHANGE,0.99,,17166.67,Savings,Swansea,UK
4990,27/06/2017,DEB,Amazon UK Marketpl,19.95,,17167.66,Amazon,Swansea,UK
4991,27/06/2017,DEB,Amazon UK Retail,7.15,,17187.61,Amazon,Swansea,UK
4992,27/06/2017,DEB,Amazon UK Marketpl,3.91,,17194.76,Amazon,Swansea,UK
4993,27/06/2017,CPT,LNK UNI - UNIVERSI,50.0,,17198.67,Cash,Swansea,UK
4994,27/06/2017,BP,SAVE THE CHANGE,0.8,,17248.67,Savings,Swansea,UK
4995,26/06/2017,DEB,JS ONLINE GROCERY,323.2,,17249.47,Groceries,Swansea,UK
4996,26/06/2017,DEP,SKETTY SWANSEA,,211.5,17572.67,Supplementary Income,Swansea,UK
4997,26/06/2017,BP,SAVE THE CHANGE,0.01,,17361.17,Savings,Swansea,UK
4998,23/06/2017,DEB,Amazon UK Marketpl,12.99,,17361.18,Amazon,Swansea,UK
4999,23/06/2017,CPT,LNK UNI - UNIVERSI,20.0,,17374.17,Cash,Swansea,UK
5000,22/06/2017,DD,CORGI HOMEPLAN CA,19.5,,17394.17,Home Improvement,Swansea,UK
5001,21/06/2017,FPI,MARIANA MILLS,,375.0,17413.67,Supplementary Income,Swansea,UK
5002,21/06/2017,CPT,LNK UNI - UNIVERSI,50.0,,17038.67,Cash,Swansea,UK
5003,21/06/2017,DD,VIRGIN MEDIA PYMTS,39.58,,17088.67,Bills,Nottingham,UK
5004,21/06/2017,BP,SAVE THE CHANGE,0.75,,17128.25,Savings,Swansea,UK
5005,20/06/2017,DEB,Amazon UK Marketpl,15.99,,17129.0,Amazon,Swansea,UK
5006,20/06/2017,DEB,Amazon UK Marketpl,11.26,,17144.99,Amazon,Swansea,UK
5007,20/06/2017,BP,SAVE THE CHANGE,2.29,,17156.25,Savings,Swansea,UK
5008,19/06/2017,DEB,Amazon UK Marketpl,80.16,,17158.54,Amazon,Swansea,UK
5009,19/06/2017,DEB,Amazon UK Retail,78.97,,17238.7,Amazon,Swansea,UK
5010,19/06/2017,DEB,Amazon UK Retail,44.96,,17317.67,Amazon,Swansea,UK
5011,19/06/2017,DEB,Amazon UK Marketpl,27.6,,17362.63,Amazon,Swansea,UK
5012,19/06/2017,DEB,AMAZON UK RETAIL A,19.98,,17390.23,Amazon,Swansea,UK
5013,19/06/2017,DEB,Amazon UK Marketpl,5.04,,17410.21,Amazon,Swansea,UK
5014,19/06/2017,DEB,COOL FISH RIDES S,,136.16,17415.25,Supplementary Income,Swansea,UK
5015,19/06/2017,BP,SAVE THE CHANGE,0.94,,17279.09,Savings,Swansea,UK
5016,16/06/2017,DEB,COOL FISH RIDES S,138.52,,17280.03,Entertainment,London,UK
5017,16/06/2017,DEB,COOL FISH RIDES S,5.54,,17418.55,Entertainment,London,UK
5018,16/06/2017,DD,O2,20.79,,17424.09,Other Shopping,Swansea,UK
5019,13/06/2017,DEB,FOREIGN CASH FEE,2.0,,17444.88,Travel,,
5020,13/06/2017,DEB,101823784,92.25,,17446.88,Others,Swansea,UK
5021,13/06/2017,BP,SAVE THE CHANGE,1.11,,17539.13,Savings,Swansea,UK
5022,2017-12-06 00:00:00,DEB,ARRIVA TRAINS WALE,8.2,,17540.24,Travel,,
5023,2017-12-06 00:00:00,DEB,Amazon UK Retail,9.69,,17548.44,Amazon,Swansea,UK
5024,2017-12-06 00:00:00,BP,SAVE THE CHANGE,0.49,,17558.13,Savings,Swansea,UK
5025,2017-12-06 00:00:00,CPT,LNK ARRIVA TRAINS,60.0,,17558.62,Cash,,
5026,2017-09-06 00:00:00,CPT,LNK UNI - UNIVERSI,50.0,,17618.62,Cash,Swansea,UK
5027,2017-09-06 00:00:00,DEB,Amazon UK Marketpl,9.51,,17668.62,Amazon,Swansea,UK
5028,2017-09-06 00:00:00,DD,LV LIFE,37.12,,17678.13,Insurance,Swansea,UK
5029,2017-09-06 00:00:00,BP,SAVE THE CHANGE,0.1,,17715.25,Savings,Swansea,UK
5030,2017-08-06 00:00:00,DEB,WWW.DEZREZLEGAL.CO,245.0,,17715.35,Insurance,Swansea,UK
5031,2017-08-06 00:00:00,DEB,WATSON & PRATTS,128.9,,17960.35,Groceries ,Lampeter,UK
5032,2017-07-06 00:00:00,BP,SAVE THE CHANGE,0.84,,18089.25,Savings,Swansea,UK
5033,2017-06-06 00:00:00,DEB,Amazon UK Marketpl,8.16,,18090.09,Amazon,Swansea,UK
5034,2017-06-06 00:00:00,CPT,LNK UNI - UNIVERSI,100.0,,18098.25,Cash,Swansea,UK
5035,2017-06-06 00:00:00,BP,SAVE THE CHANGE,1.61,,18198.25,Savings,Swansea,UK
5036,2017-05-06 00:00:00,DEB,Amazon UK Marketpl,6.44,,18199.86,Amazon,Swansea,UK
5037,2017-05-06 00:00:00,DEB,Amazon UK Marketpl,12.44,,18206.3,Amazon,Swansea,UK
5038,2017-05-06 00:00:00,DEB,Amazon Svcs Europe,8.52,,18218.74,Amazon,Swansea,UK
5039,2017-05-06 00:00:00,DEB,AMAZON.CO.UK,6.99,,18227.26,Amazon,Swansea,UK
5040,2017-05-06 00:00:00,DD,ASSURANT INTER LTD,39.74,,18234.25,Insurance,Swansea,UK
5041,2017-05-06 00:00:00,BP,SAVE THE CHANGE,0.55,,18273.99,Savings,Swansea,UK
5042,2017-02-06 00:00:00,DEB,AMAZON.CO.UK,18.45,,18274.54,Amazon,Swansea,UK
5043,2017-02-06 00:00:00,CPT,LNK UNI - UNIVERSI,40.0,,18292.99,Cash,Swansea,UK
5044,2017-01-06 00:00:00,FEE,ACCOUNT FEE,9.95,,18332.99,Bills,Swansea,UK
5045,2017-01-06 00:00:00,CPT,LNK UNI - UNIVERSI,50.0,,18342.94,Cash,Swansea,UK
5046,2017-01-06 00:00:00,DD,NATWEST BANK,828.49,,18392.94,Mortgage,Swansea,UK
5047,2017-01-06 00:00:00,DD,CC SWANSEA C.TAX,174.0,,19221.43,Bills,Swansea,UK
5048,2017-01-06 00:00:00,DD,GOOD ENERGY LTD,85.0,,19395.43,Bills,Swansea,UK
5049,2017-01-06 00:00:00,DD,DWR CYMRU W WATER,32.5,,19480.43,Bills,Swansea,UK
5050,2017-01-06 00:00:00,DD,TV LICENCE MBP,12.37,,19512.93,Bills,Swansea,UK
5051,2017-01-06 00:00:00,SO,ESAVINGS ACCOUNT,300.0,,19525.3,Savings,Swansea,UK
5052,31/05/2017,DD,UCU B ACCOUNT,22.7,,19825.3,Others,Swansea,UK
5053,31/05/2017,BP,SAVE THE CHANGE,0.4,,19848.0,Savings,Swansea,UK
5054,31/05/2017,BGC,SWANSEA UNI - PAY,,3138.65,19848.4,Paycheck,Swansea,UK
5055,30/05/2017,DEB,ARRIVA TRAINS WALE,166.6,,16709.75,Travel,,
5056,30/05/2017,BP,SAVE THE CHANGE,0.51,,16876.35,Savings,Swansea,UK
5057,30/05/2017,CPT,LNK RAIL BRISTOL T,50.0,,16876.86,Cash,Bristol,
5058,26/05/2017,DEB,Amazon UK Retail,9.99,,16926.86,Amazon,Swansea,UK
5059,26/05/2017,DEB,AMAZON UK RETAIL A,12.5,,16936.85,Amazon,Swansea,UK
5060,26/05/2017,CPT,LNK UNI - UNIVERSI,80.0,,16949.35,Cash,Swansea,UK
5061,26/05/2017,BP,SAVE THE CHANGE,1.49,,17029.35,Savings,Swansea,UK
5062,25/05/2017,CPT,LNK UPLANDS CRESCE,100.0,,17030.84,Cash,Swansea,UK
5063,25/05/2017,DEB,AMAZON UK RETAIL A,8.16,,17130.84,Amazon,Swansea,UK
5064,25/05/2017,DEB,Amazon UK Marketpl,2.35,,17139.0,Amazon,Swansea,UK
5065,25/05/2017,BP,SAVE THE CHANGE,0.12,,17141.35,Savings,Swansea,UK
5066,24/05/2017,DEB,Amazon UK Marketpl,6.96,,17141.47,Amazon,Swansea,UK
5067,24/05/2017,DEB,AMAZON UK RETAIL A,10.92,,17148.43,Amazon,Swansea,UK
5068,24/05/2017,BP,SAVE THE CHANGE,1.45,,17159.35,Savings,Swansea,UK
5069,23/05/2017,DEB,Amazon UK Marketpl,16.06,,17160.8,Amazon,Swansea,UK
5070,23/05/2017,DEB,AMAZON UK RETAIL A,10.49,,17176.86,Amazon,Swansea,UK
5071,23/05/2017,CPT,LNK UNI - UNIVERSI,60.0,,17187.35,Cash,Swansea,UK
5072,23/05/2017,BP,SAVE THE CHANGE,0.01,,17247.35,Savings,Swansea,UK
5073,22/05/2017,DEB,Amazon UK Marketpl,6.99,,17247.36,Amazon,Swansea,UK
5074,22/05/2017,DD,VIRGIN MEDIA PYMTS,31.48,,17254.35,Bills,Nottingham,UK
5075,22/05/2017,DD,CORGI HOMEPLAN CA,19.5,,17285.83,Home Improvement,Swansea,UK
5076,22/05/2017,BP,SAVE THE CHANGE,1.51,,17305.33,Savings,Swansea,UK
5077,19/05/2017,DEB,ARRIVA TRAINS WALE,22.4,,17306.84,Travel,,
5078,19/05/2017,DEB,Amazon UK Retail,5.75,,17329.24,Amazon,Swansea,UK
5079,19/05/2017,DEB,AMAZON UK RETAIL A,11.34,,17334.99,Amazon,Swansea,UK
5080,19/05/2017,BP,SAVE THE CHANGE,0.71,,17346.33,Savings,Swansea,UK
5081,18/05/2017,DEB,AMAZON.CO.UK,15.29,,17347.04,Amazon,Swansea,UK
5082,18/05/2017,CPT,LNK UNI - UNIVERSI,100.0,,17362.33,Cash,Swansea,UK
5083,17/05/2017,BP,SAVE THE CHANGE,0.02,,17462.33,Savings,Swansea,UK
5084,16/05/2017,DEB,Amazon UK Retail,23.98,,17462.35,Amazon,Swansea,UK
5085,16/05/2017,CPT,LNK UNI - UNIVERSI,100.0,,17486.33,Cash,Swansea,UK
5086,16/05/2017,DD,O2,18.06,,17586.33,Other Shopping,Swansea,UK
5087,16/05/2017,BP,SAVE THE CHANGE,0.01,,17604.39,Savings,Swansea,UK
5088,15/05/2017,DEB,Amazon UK Marketpl,7.99,,17604.4,Amazon,Swansea,UK
5089,15/05/2017,DEB,WWW.DEZREZLEGAL.CO,50.0,,17612.39,Insurance,Swansea,UK
5090,15/05/2017,CPT,LNK UNI - UNIVERSI,50.0,,17662.39,Cash,Swansea,UK
5091,2017-12-05 00:00:00,CPT,LNK UNI - UNIVERSI,30.0,,17712.39,Cash,Swansea,UK
5092,2017-09-05 00:00:00,CPT,LNK SWANSEA WIND S,50.0,,17742.39,Cash,Swansea,UK
5093,2017-09-05 00:00:00,DEB,TICKETS08712200260,33.0,,17792.39,Travel,,
5094,2017-08-05 00:00:00,DEB,PERSIMMON HOMES WE,200.0,,17825.39,Home Improvement,Swansea,UK
5095,2017-08-05 00:00:00,DD,LV LIFE,37.12,,18025.39,Insurance,Swansea,UK
5096,2017-05-05 00:00:00,DEB,WWW.DEZREZLEGAL.CO,25.0,,18062.51,Insurance,Swansea,UK
5097,2017-05-05 00:00:00,CPT,LOYD TALIESIN BUIL,50.0,,18087.51,Cash,,
5098,2017-03-05 00:00:00,DD,ASSURANT INTER LTD,39.74,,18137.51,Insurance,Swansea,UK
5099,2017-03-05 00:00:00,BP,SAVE THE CHANGE,1.13,,18177.25,Savings,Swansea,UK
5100,2017-02-05 00:00:00,FEE,ACCOUNT FEE,9.95,,18178.38,Bills,Swansea,UK
5101,2017-02-05 00:00:00,DEB,GRUPO HOTELES PLAY,607.58,,18188.33,Hotels,Almería,Spain
5102,2017-02-05 00:00:00,DEB,SUSU TRADING LTD,37.29,,18795.91,Home Improvement,Swansea,UK
5103,2017-02-05 00:00:00,CPT,LNK UNI - UNIVERSI,50.0,,18833.2,Cash,Swansea,UK
5104,2017-02-05 00:00:00,DD,NATWEST BANK,828.49,,18883.2,Mortgage,Swansea,UK
5105,2017-02-05 00:00:00,DD,CC SWANSEA C.TAX,174.0,,19711.69,Bills,Swansea,UK
5106,2017-02-05 00:00:00,DD,GOOD ENERGY LTD,85.0,,19885.69,Bills,Swansea,UK
5107,2017-02-05 00:00:00,DD,DWR CYMRU W WATER,32.5,,19970.69,Bills,Swansea,UK
5108,2017-02-05 00:00:00,DD,TV LICENCE MBP,12.12,,20003.19,Bills,Swansea,UK
5109,2017-02-05 00:00:00,SO,ESAVINGS ACCOUNT,300.0,,20015.31,Savings,Swansea,UK
5110,2017-02-05 00:00:00,BGC,SWANSEA UNIVERSITY,,692.67,20315.31,Supplementary Income,Swansea,UK
5111,28/04/2017,CPT,LNK UNI - UNIVERSI,30.0,,19622.64,Cash,Swansea,UK
5112,28/04/2017,DD,UCU B ACCOUNT,22.7,,19652.64,Others,Swansea,UK
5113,28/04/2017,BGC,SWANSEA UNI - PAY,,3138.66,19675.34,Paycheck,Swansea,UK
5114,26/04/2017,BP,SAVE THE CHANGE,0.03,,16536.68,Savings,Swansea,UK
5115,25/04/2017,DEB,Amazon UK Marketpl,15.97,,16536.71,Amazon,Swansea,UK
5116,25/04/2017,CPT,LNK UNI - UNIVERSI,40.0,,16552.68,Cash,Swansea,UK
5117,25/04/2017,DD,CORGI HOMEPLAN CA,19.5,,16592.68,Home Improvement,Swansea,UK
5118,25/04/2017,BP,SAVE THE CHANGE,0.6,,16612.18,Savings,Swansea,UK
5119,24/04/2017,DEB,AMAZON UK RETAIL A,10.81,,16612.78,Amazon,Swansea,UK
5120,24/04/2017,DEB,KLM UK  074132,265.59,,16623.59,Travel,,
5121,24/04/2017,DEB,EXPEDIA 7260559230,3.0,,16889.18,Travel,,
5122,21/04/2017,CPT,LNK UNI - UNIVERSI,30.0,,16892.18,Cash,Swansea,UK
5123,21/04/2017,DD,VIRGIN MEDIA PYMTS,31.48,,16922.18,Bills,Nottingham,UK
5124,21/04/2017,BP,SAVE THE CHANGE,0.01,,16953.66,Savings,Swansea,UK
5125,20/04/2017,DEB,Amazon Svcs Europe,4.99,,16953.67,Amazon,Swansea,UK
5126,20/04/2017,BP,SAVE THE CHANGE,0.74,,16958.66,Savings,Swansea,UK
5127,19/04/2017,DEB,Amazon UK Marketpl,37.71,,16959.4,Amazon,Swansea,UK
5128,19/04/2017,DEB,Amazon UK Marketpl,5.8,,16997.11,Amazon,Swansea,UK
5129,19/04/2017,DEB,Amazon UK Marketpl,5.75,,17002.91,Amazon,Swansea,UK
5130,19/04/2017,CPT,LNK LIFESTYLE EXPR,250.0,,17008.66,Cash,Leicester,UK
5131,19/04/2017,CPT,LNK UNI - UNIVERSI,40.0,,17258.66,Cash,Swansea,UK
5132,19/04/2017,DD,O2,31.13,,17298.66,Other Shopping,Swansea,UK
5133,19/04/2017,BP,SAVE THE CHANGE,0.77,,17329.79,Savings,Swansea,UK
5134,18/04/2017,DEB,AMAZON UK RETAIL A,3.99,,17330.56,Amazon,Swansea,UK
5135,18/04/2017,DEB,Amazon UK Marketpl,3.24,,17334.55,Amazon,Swansea,UK
5136,18/04/2017,BGC,SWANSEA UNIVERSITY,,151.28,17337.79,Supplementary Income,Swansea,UK
5137,18/04/2017,CPT,LNK SALUBRIOUS PLA,40.0,,17186.51,Cash,,
5138,13/04/2017,CPT,LNK UNI - UNIVERSI,80.0,,17226.51,Cash,Swansea,UK
5139,13/04/2017,BP,SAVE THE CHANGE,0.45,,17306.51,Savings,Swansea,UK
5140,2017-12-04 00:00:00,DEB,Amazon UK Marketpl,13.93,,17306.96,Amazon,Swansea,UK
5141,2017-12-04 00:00:00,DEB,Amazon UK Marketpl,6.62,,17320.89,Amazon,Swansea,UK
5142,2017-12-04 00:00:00,BP,SAVE THE CHANGE,0.91,,17327.51,Savings,Swansea,UK
5143,2017-11-04 00:00:00,DEB,Amazon UK Marketpl,11.09,,17328.42,Amazon,Swansea,UK
5144,2017-11-04 00:00:00,BP,SAVE THE CHANGE,0.67,,17339.51,Savings,Swansea,UK
5145,2017-10-04 00:00:00,DEB,JS ONLINE GROCERY,315.35,,17340.18,Groceries,Swansea,UK
5146,2017-10-04 00:00:00,DEB,Amazon UK Marketpl,10.98,,17655.53,Amazon,Swansea,UK
5147,2017-10-04 00:00:00,DD,LV LIFE,37.12,,17666.51,Insurance,Swansea,UK
5148,2017-07-04 00:00:00,CPT,LNK UNI - UNIVERSI,40.0,,17703.63,Cash,Swansea,UK
5149,2017-07-04 00:00:00,BP,SAVE THE CHANGE,0.75,,17743.63,Savings,Swansea,UK
5150,2017-06-04 00:00:00,DEB,WATSON & PRATTS,138.25,,17744.38,Groceries ,Lampeter,UK
5151,2017-05-04 00:00:00,CPT,LNK UNI - UNIVERSI,50.0,,17882.63,Cash,Swansea,UK
5152,2017-05-04 00:00:00,BP,SAVE THE CHANGE,0.04,,17932.63,Savings,Swansea,UK
5153,2017-04-04 00:00:00,DEB,AMAZON UK RETAIL A,104.98,,17932.67,Amazon,Swansea,UK
5154,2017-04-04 00:00:00,DEB,Amazon UK Marketpl,17.98,,18037.65,Amazon,Swansea,UK
5155,2017-04-04 00:00:00,BP,SAVE THE CHANGE,0.12,,18055.63,Savings,Swansea,UK
5156,2017-03-04 00:00:00,FEE,ACCOUNT FEE,9.95,,18055.75,Bills,Swansea,UK
5157,2017-03-04 00:00:00,DEB,Amazon UK Marketpl,15.99,,18065.7,Amazon,Swansea,UK
5158,2017-03-04 00:00:00,DEB,Amazon UK Marketpl,9.99,,18081.69,Amazon,Swansea,UK
5159,2017-03-04 00:00:00,DEB,AMAZON UK RETAIL A,35.9,,18091.68,Amazon,Swansea,UK
5160,2017-03-04 00:00:00,DD,NATWEST BANK,828.49,,18127.58,Mortgage,Swansea,UK
5161,2017-03-04 00:00:00,DD,CC SWANSEA C.TAX,177.49,,18956.07,Bills,Swansea,UK
5162,2017-03-04 00:00:00,DD,GOOD ENERGY LTD,85.0,,19133.56,Bills,Swansea,UK
5163,2017-03-04 00:00:00,DD,ASSURANT INTER LTD,39.74,,19218.56,Insurance,Swansea,UK
5164,2017-03-04 00:00:00,DD,DWR CYMRU W WATER,32.5,,19258.3,Bills,Swansea,UK
5165,2017-03-04 00:00:00,DD,TV LICENCE MBP,12.12,,19290.8,Bills,Swansea,UK
5166,2017-03-04 00:00:00,SO,ESAVINGS ACCOUNT,300.0,,19302.92,Savings,Swansea,UK
5167,31/03/2017,DEB,NON-STG CASH FEE,2.0,,19602.92,Others,Swansea,UK
5168,31/03/2017,DEB,NON-STG TRANS FEE,2.47,,19604.92,Others,Swansea,UK
5169,31/03/2017,DEB,TETOUAN MHANNEC,82.74,,19607.39,Services,Swansea,UK
5170,31/03/2017,DD,UCU B ACCOUNT,22.7,,19690.13,Others,Swansea,UK
5171,31/03/2017,DEB,NON-STG CASH FEE,2.0,,19712.83,Others,Swansea,UK
5172,31/03/2017,DEB,NON-STG TRANS FEE,2.47,,19714.83,Others,Swansea,UK
5173,31/03/2017,DEB,CASA AEREPORT M,82.69,,19717.3,Travel,Casablanca,Morocco
5174,31/03/2017,BP,SAVE THE CHANGE,0.03,,19799.99,Savings,Swansea,UK
5175,31/03/2017,BGC,SWANSEA UNI - PAY,,3112.59,19800.02,Paycheck,Swansea,UK
5176,30/03/2017,DEB,Amazon UK Marketpl,1.97,,16687.43,Amazon,Swansea,UK
5177,28/03/2017,BP,SAVE THE CHANGE,0.01,,16689.4,Savings,Swansea,UK
5178,27/03/2017,DEB,Amazon UK Marketpl,26.99,,16689.41,Amazon,Swansea,UK
5179,27/03/2017,DEB,Amazon UK Marketpl,6.0,,16716.4,Amazon,Swansea,UK
5180,27/03/2017,BP,SAVE THE CHANGE,0.68,,16722.4,Savings,Swansea,UK
5181,24/03/2017,DEB,Amazon UK Retail,9.9,,16723.08,Amazon,Swansea,UK
5182,24/03/2017,DEB,AMAZON UK RETAIL A,9.42,,16732.98,Amazon,Swansea,UK
5183,24/03/2017,BP,SAVE THE CHANGE,0.3,,16742.4,Savings,Swansea,UK
5184,23/03/2017,CPT,LOYD TALIESIN BUIL,100.0,,16742.7,Cash,,
5185,23/03/2017,DEB,AMAZON UK RETAIL A,35.7,,16842.7,Amazon,Swansea,UK
5186,23/03/2017,BP,SAVE THE CHANGE,0.21,,16878.4,Savings,Swansea,UK
5187,22/03/2017,DEB,Amazon UK Retail,4.79,,16878.61,Amazon,Swansea,UK
5188,22/03/2017,CPT,LNK UNI - UNIVERSI,100.0,,16883.4,Cash,Swansea,UK
5189,22/03/2017,DD,CORGI HOMEPLAN CA,19.5,,16983.4,Home Improvement,Swansea,UK
5190,21/03/2017,CPT,LNK UNI - UNIVERSI,50.0,,17002.9,Cash,Swansea,UK
5191,21/03/2017,DD,VIRGIN MEDIA PYMTS,31.48,,17052.9,Bills,Nottingham,UK
5192,21/03/2017,BP,SAVE THE CHANGE,1.84,,17084.38,Savings,Swansea,UK
5193,20/03/2017,DEB,AMAZON UK RETAIL A,93.73,,17086.22,Amazon,Swansea,UK
5194,20/03/2017,DEB,IKEA ONLINE,82.5,,17179.95,Other Shopping,,
5195,20/03/2017,DEB,Amazon UK Retail,8.97,,17262.45,Amazon,Swansea,UK
5196,20/03/2017,DEB,GWR WEBSALES,112.7,,17271.42,Travel,,
5197,20/03/2017,DEB,Amazon UK Marketpl,5.26,,17384.12,Amazon,Swansea,UK
5198,17/03/2017,DEB,AMZ*MokenEye-UK,,35.99,17389.38,Supplementary Income,Swansea,UK
5199,17/03/2017,CPT,LNK UNI - UNIVERSI,30.0,,17353.39,Cash,Swansea,UK
5200,17/03/2017,BP,SAVE THE CHANGE,0.75,,17383.39,Savings,Swansea,UK
5201,16/03/2017,DEB,AMAZON.CO.UK,7.25,,17384.14,Amazon,Swansea,UK
5202,16/03/2017,CPT,LNK UNI - UNIVERSI,50.0,,17391.39,Cash,Swansea,UK
5203,16/03/2017,DD,O2,16.83,,17441.39,Other Shopping,Swansea,UK
5204,16/03/2017,BP,SAVE THE CHANGE,0.54,,17458.22,Savings,Swansea,UK
5205,15/03/2017,DEB,Amazon UK Marketpl,3.46,,17458.76,Amazon,Swansea,UK
5206,15/03/2017,BP,SAVE THE CHANGE,1.94,,17462.22,Savings,Swansea,UK
5207,14/03/2017,DEB,Amazon UK Marketpl,12.86,,17464.16,Amazon,Swansea,UK
5208,14/03/2017,DEB,Amazon UK Marketpl,10.05,,17477.02,Amazon,Swansea,UK
5209,14/03/2017,DEB,NON-STG PURCH FEE,1.0,,17487.07,Others,Swansea,UK
5210,14/03/2017,DEB,NON-STG TRANS FEE,8.67,,17488.07,Others,Swansea,UK
5211,14/03/2017,DEB,AIRMARO G.B I,290.15,,17496.74,Travel,,
5212,14/03/2017,BP,SAVE THE CHANGE,0.6,,17786.89,Savings,Swansea,UK
5213,13/03/2017,DEB,ARRIVA TRAINS WALE,22.4,,17787.49,Travel,,
5214,13/03/2017,CPT,LNK ARRIVA TRAINS,80.0,,17809.89,Cash,,
5215,2017-10-03 00:00:00,DEB,AMAZON UK PRIME AM,79.0,,17889.89,Amazon,Swansea,UK
5216,2017-10-03 00:00:00,CPT,LNK UNI - UNIVERSI,60.0,,17968.89,Cash,Swansea,UK
5217,2017-10-03 00:00:00,BP,SAVE THE CHANGE,0.97,,18028.89,Savings,Swansea,UK
5218,2017-09-03 00:00:00,DEB,Amazon UK Marketpl,20.03,,18029.86,Amazon,Swansea,UK
5219,2017-09-03 00:00:00,BP,SAVE THE CHANGE,0.17,,18049.89,Savings,Swansea,UK
5220,2017-08-03 00:00:00,DEB,AMAZON UK RETAIL A,5.83,,18050.06,Amazon,Swansea,UK
5221,2017-08-03 00:00:00,CPT,LNK UNI - UNIVERSI,30.0,,18055.89,Cash,Swansea,UK
5222,2017-08-03 00:00:00,DD,LV LIFE,37.12,,18085.89,Insurance,Swansea,UK
5223,2017-07-03 00:00:00,BP,SAVE THE CHANGE,2.05,,18123.01,Savings,Swansea,UK
5224,2017-06-03 00:00:00,DEB,Amazon UK Marketpl,35.99,,18125.06,Amazon,Swansea,UK
5225,2017-06-03 00:00:00,DEB,ARRIVA TRAINS WALE,95.3,,18161.05,Travel,,
5226,2017-06-03 00:00:00,DEB,ASHA'S,42.2,,18256.35,Dine Out,,
5227,2017-06-03 00:00:00,DEB,Amazon UK Marketpl,10.88,,18298.55,Amazon,Swansea,UK
5228,2017-06-03 00:00:00,DEB,WASABI BIRMINGHAM,10.58,,18309.43,Dine Out,Birmingham,UK
5229,2017-06-03 00:00:00,CPT,LNK UNI - UNIVERSI,50.0,,18320.01,Cash,Swansea,UK
5230,2017-06-03 00:00:00,BP,SAVE THE CHANGE,0.75,,18370.01,Savings,Swansea,UK
5231,2017-03-03 00:00:00,DEB,Amazon UK Marketpl,20.79,,18370.76,Amazon,Swansea,UK
5232,2017-03-03 00:00:00,DEB,Amazon UK Marketpl,5.46,,18391.55,Amazon,Swansea,UK
5233,2017-03-03 00:00:00,DD,ASSURANT INTER LTD,39.74,,18397.01,Savings,Swansea,UK
5234,2017-02-03 00:00:00,CPT,LNK UNI - UNIVERSI,50.0,,18436.75,Cash,Swansea,UK
5235,2017-02-03 00:00:00,BP,SAVE THE CHANGE,0.63,,18486.75,Savings,Swansea,UK
5236,2017-01-03 00:00:00,FEE,ACCOUNT FEE,9.95,,18487.38,Bills,Swansea,UK
5237,2017-01-03 00:00:00,DEB,Amazon UK Marketpl,8.38,,18497.33,Amazon,Swansea,UK
5238,2017-01-03 00:00:00,DEB,AMAZON UK RETAIL A,3.99,,18505.71,Amazon,Swansea,UK
5239,2017-01-03 00:00:00,DD,NATWEST BANK,828.49,,18509.7,Mortgage,Swansea,UK
5240,2017-01-03 00:00:00,DD,GOOD ENERGY LTD,85.0,,19338.19,Bills,Swansea,UK
5241,2017-01-03 00:00:00,DD,DWR CYMRU W WATER,32.5,,19423.19,Bills,Swansea,UK
5242,2017-01-03 00:00:00,DD,TV LICENCE MBP,12.12,,19455.69,Bills,Swansea,UK
5243,2017-01-03 00:00:00,SO,ESAVINGS ACCOUNT,300.0,,19467.81,Savings,Swansea,UK
5244,28/02/2017,CPT,LNK UNI - UNIVERSI,50.0,,19767.81,Cash,Swansea,UK
5245,28/02/2017,DD,UCU B ACCOUNT,22.7,,19817.81,Others,Swansea,UK
5246,28/02/2017,BP,SAVE THE CHANGE,0.98,,19840.51,Savings,Swansea,UK
5247,28/02/2017,BGC,SWANSEA UNI - PAY,,3112.59,19841.49,Paycheck,Swansea,UK
5248,27/02/2017,DEB,AMAZON UK RETAIL A,26.02,,16728.9,Amazon,Swansea,UK
5249,24/02/2017,CPT,LNK UNI - UNIVERSI,50.0,,16754.92,Cash,Swansea,UK
5250,23/02/2017,BP,SAVE THE CHANGE,0.54,,16804.92,Savings,Swansea,UK
5251,22/02/2017,DEB,Amazon UK Marketpl,26.46,,16805.46,Amazon,Swansea,UK
5252,22/02/2017,DD,CORGI HOMEPLAN CA,19.5,,16831.92,Home Improvement,Swansea,UK
5253,22/02/2017,BP,SAVE THE CHANGE,0.38,,16851.42,Savings,Swansea,UK
5254,21/02/2017,DEB,Amazon UK Marketpl,3.63,,16851.8,Amazon,Swansea,UK
5255,21/02/2017,DEB,AMAZON UK RETAIL A,9.99,,16855.43,Amazon,Swansea,UK
5256,21/02/2017,CPT,LNK UNI - UNIVERSI,50.0,,16865.42,Cash,Swansea,UK
5257,21/02/2017,DD,VIRGIN MEDIA PYMTS,31.48,,16915.42,Bills,Nottingham,UK
5258,21/02/2017,BP,SAVE THE CHANGE,0.02,,16946.9,Savings,Swansea,UK
5259,20/02/2017,DEB,Amazon UK Marketpl,7.98,,16946.92,Amazon,Swansea,UK
5260,17/02/2017,CPT,LNK UNI - UNIVERSI,40.0,,16954.9,Cash,Swansea,UK
5261,17/02/2017,CHQ,51,156.0,,16994.9,Cash,,
5262,17/02/2017,BP,SAVE THE CHANGE,0.94,,17150.9,Savings,Swansea,UK
5263,16/02/2017,DEB,Amazon UK Marketpl,7.82,,17151.84,Amazon,Swansea,UK
5264,16/02/2017,DEB,Amazon UK Marketpl,3.24,,17159.66,Amazon,Swansea,UK
5265,16/02/2017,DD,O2,16.83,,17162.9,Other Shopping,Swansea,UK
5266,15/02/2017,CPT,LNK UNI - UNIVERSI,40.0,,17179.73,Cash,Swansea,UK
5267,13/02/2017,CPT,LNK UNI - UNIVERSI,50.0,,17219.73,Cash,Swansea,UK
5268,13/02/2017,BP,SAVE THE CHANGE,1.35,,17269.73,Savings,Swansea,UK
5269,2017-10-02 00:00:00,DEB,WWW.ORGANICFRESHFO,122.58,,17271.08,Groceries,Swansea,UK
5270,2017-10-02 00:00:00,DEB,Amazon UK Marketpl,12.07,,17393.66,Amazon,Swansea,UK
5271,2017-10-02 00:00:00,CPT,LNK UNI - UNIVERSI,30.0,,17405.73,Cash,Swansea,UK
5272,2017-10-02 00:00:00,BP,SAVE THE CHANGE,0.45,,17435.73,Savings,Swansea,UK
5273,2017-09-02 00:00:00,DEB,Amazon UK Marketpl,8.55,,17436.18,Amazon,Swansea,UK
5274,2017-08-02 00:00:00,CPT,LNK UNI - UNIVERSI,40.0,,17444.73,Cash,Swansea,UK
5275,2017-08-02 00:00:00,DD,LV LIFE,37.12,,17484.73,Insurance,Swansea,UK
5276,2017-07-02 00:00:00,CPT,LNK UNI - UNIVERSI,50.0,,17521.85,Cash,Swansea,UK
5277,2017-07-02 00:00:00,BP,SAVE THE CHANGE,0.59,,17571.85,Savings,Swansea,UK
5278,2017-06-02 00:00:00,DEB,Amazon UK Marketpl,4.41,,17572.44,Amazon,Swansea,UK
5279,2017-06-02 00:00:00,DEB,Amazon UK Marketpl,6.0,,17576.85,Amazon,Swansea,UK
5280,2017-03-02 00:00:00,CPT,LNK UNI - UNIVERSI,30.0,,17582.85,Cash,Swansea,UK
5281,2017-03-02 00:00:00,DD,GOOD ENERGY LTD,85.0,,17612.85,Bills,Swansea,UK
5282,2017-03-02 00:00:00,DD,ASSURANT INTER LTD,39.74,,17697.85,Insurance,Swansea,UK
5283,2017-03-02 00:00:00,BP,SAVE THE CHANGE,0.49,,17737.59,Savings,Swansea,UK
5284,2017-02-02 00:00:00,DEB,Amazon UK Marketpl,17.99,,17738.08,Amazon,Swansea,UK
5285,2017-02-02 00:00:00,DEB,Amazon UK Marketpl,16.52,,17756.07,Amazon,Swansea,UK
5286,2017-02-02 00:00:00,CPT,LNK UNI - UNIVERSI,50.0,,17772.59,Cash,Swansea,UK
5287,2017-01-02 00:00:00,FEE,ACCOUNT FEE,9.95,,17822.59,Bills,Swansea,UK
5288,2017-01-02 00:00:00,DD,NATWEST BANK,828.49,,17832.54,Mortgage,Swansea,UK
5289,2017-01-02 00:00:00,DD,DWR CYMRU W WATER,32.5,,18661.03,Bills,Swansea,UK
5290,2017-01-02 00:00:00,DD,TV LICENCE MBP,12.12,,18693.53,Bills,Swansea,UK
5291,2017-01-02 00:00:00,SO,ESAVINGS ACCOUNT,300.0,,18705.65,Savings,Swansea,UK
5292,2017-01-02 00:00:00,BP,SAVE THE CHANGE,0.01,,19005.65,Savings,Swansea,UK
5293,31/01/2017,DEB,Amazon UK Marketpl,4.99,,19005.66,Amazon,Swansea,UK
5294,31/01/2017,CPT,LNK UNI - UNIVERSI,50.0,,19010.65,Cash,Swansea,UK
5295,31/01/2017,DD,UCU B ACCOUNT,22.7,,19060.65,Others,Swansea,UK
5296,31/01/2017,BP,SAVE THE CHANGE,0.73,,19083.35,Savings,Swansea,UK
5297,31/01/2017,BGC,SWANSEA UNI - PAY,,3113.0,19084.08,Paycheck,Swansea,UK
5298,30/01/2017,DEB,Amazon UK Marketpl,1.27,,15971.08,Amazon,Swansea,UK
5299,30/01/2017,BP,SAVE THE CHANGE,2.02,,15972.35,Savings,Swansea,UK
5300,27/01/2017,DEB,JS ONLINE GROCERY,210.85,,15974.37,Groceries,Swansea,UK
5301,27/01/2017,DEB,Amazon UK Marketpl,20.03,,16185.22,Amazon,Swansea,UK
5302,27/01/2017,DEB,Amazon UK Marketpl,5.4,,16205.25,Amazon,Swansea,UK
5303,27/01/2017,DEB,Amazon UK Retail,2.7,,16210.65,Amazon,Swansea,UK
5304,27/01/2017,CPT,LNK THE KINGSWAY,60.0,,16213.35,Cash,,
5305,27/01/2017,BGC,SWANSEA UNIVERSITY,,168.35,16273.35,Supplementary Income,Swansea,UK
5306,25/01/2017,FPO,JOHN DEMISA,81.0,,16105.0,Services,Swansea,UK
5307,25/01/2017,CPT,LNK UNI - UNIVERSI,50.0,,16186.0,Cash,Swansea,UK
5308,25/01/2017,BP,SAVE THE CHANGE,0.05,,16236.0,Savings,Swansea,UK
5309,24/01/2017,DEB,TICKETS 0871220026,174.0,,16236.05,Travel,,
5310,24/01/2017,DEB,Amazon UK Marketpl,15.95,,16410.05,Amazon,Swansea,UK
5311,24/01/2017,BP,SAVE THE CHANGE,0.73,,16426.0,Savings,Swansea,UK
5312,23/01/2017,DEB,ODEON,20.0,,16426.73,Entertainment,,
5313,23/01/2017,DEB,Amazon UK Marketpl,1.27,,16446.73,Amazon,Swansea,UK
5314,23/01/2017,CPT,LNK UNI - UNIVERSI,60.0,,16448.0,Cash,Swansea,UK
5315,23/01/2017,DD,VIRGIN MEDIA PYMTS,31.48,,16508.0,Bills,Nottingham,UK
5316,23/01/2017,DD,CORGI HOMEPLAN CA,19.5,,16539.48,Home Improvement,Swansea,UK
5317,20/01/2017,CPT,LNK UNI - UNIVERSI,60.0,,16558.98,Cash,Swansea,UK
5318,17/01/2017,CPT,LNK UNI - UNIVERSI,60.0,,16618.98,Cash,Swansea,UK
5319,17/01/2017,BP,SAVE THE CHANGE,0.01,,16678.98,Savings,Swansea,UK
5320,16/01/2017,DEB,Amazon UK Marketpl,11.99,,16678.99,Amazon,Swansea,UK
5321,16/01/2017,DD,O2,18.82,,16690.98,Other Shopping,Swansea,UK
5322,13/01/2017,CPT,LNK UNI - UNIVERSI,50.0,,16709.8,Cash,Swansea,UK
5323,13/01/2017,BP,SAVE THE CHANGE,0.93,,16759.8,Savings,Swansea,UK
5324,2017-12-01 00:00:00,DEB,Amazon UK Marketpl,12.07,,16760.73,Amazon,Swansea,UK
5325,2017-11-01 00:00:00,BP,SAVE THE CHANGE,0.22,,16772.8,Savings,Swansea,UK
5326,2017-10-01 00:00:00,DEB,Amazon UK Marketpl,23.78,,16773.02,Amazon,Swansea,UK
5327,2017-10-01 00:00:00,CPT,LNK UNI - UNIVERSI,50.0,,16796.8,Cash,Swansea,UK
5328,2017-09-01 00:00:00,CPT,LNK UNI - UNIVERSI,30.0,,16846.8,Cash,Swansea,UK
5329,2017-09-01 00:00:00,DD,LV LIFE,37.12,,16876.8,Insurance,Swansea,UK
5330,2017-06-01 00:00:00,CPT,LNK UNI - UNIVERSI,50.0,,16913.92,Cash,Swansea,UK
5331,2017-06-01 00:00:00,BP,SAVE THE CHANGE,0.58,,16963.92,Savings,Swansea,UK
5332,2017-05-01 00:00:00,DEB,WWW.ORGANICFRESHFO,112.42,,16964.5,Groceries,Swansea,UK
5333,2017-05-01 00:00:00,DEB,AMAZON UK RETAIL A,12.0,,17076.92,Amazon,Swansea,UK
5334,2017-05-01 00:00:00,BP,SAVE THE CHANGE,0.69,,17088.92,Savings,Swansea,UK
5335,2017-04-01 00:00:00,DEB,Amazon UK Marketpl,10.58,,17089.61,Amazon,Swansea,UK
5336,2017-04-01 00:00:00,DEB,Amazon UK Marketpl,1.73,,17100.19,Amazon,Swansea,UK
5337,2017-04-01 00:00:00,BP,SAVE THE CHANGE,1.42,,17101.92,Savings,Swansea,UK
5338,2017-03-01 00:00:00,FEE,ACCOUNT FEE,9.95,,17103.34,Bills,Swansea,UK
5339,2017-03-01 00:00:00,DEB,VUE BSL LTD,24.48,,17113.29,Entertainment,,
5340,2017-03-01 00:00:00,DEB,AMAZON UK RETAIL A,8.1,,17137.77,Amazon,Swansea,UK
5341,2017-03-01 00:00:00,DD,NATWEST BANK,828.49,,17145.87,Mortgage,Swansea,UK
5342,2017-03-01 00:00:00,DD,CC SWANSEA C.TAX,233.0,,17974.36,Bills,Swansea,UK
5343,2017-03-01 00:00:00,DD,GOOD ENERGY GAS,43.0,,18207.36,Bills,Swansea,UK
5344,2017-03-01 00:00:00,DD,GOOD ENERGY LTD,42.0,,18250.36,Bills,Swansea,UK
5345,2017-03-01 00:00:00,DD,ASSURANT INTER LTD,39.74,,18292.36,Insurance,Swansea,UK
5346,2017-03-01 00:00:00,DD,DWR CYMRU W WATER,32.5,,18332.1,Bills,Swansea,UK
5347,2017-03-01 00:00:00,DD,TV LICENCE MBP,12.12,,18364.6,Bills,Swansea,UK
5348,2017-03-01 00:00:00,SO,ESAVINGS ACCOUNT,300.0,,18376.72,Savings,Swansea,UK
5349,2017-03-01 00:00:00,CPT,LNK SWANSEA WIND S,50.0,,18676.72,Cash,Swansea,UK
5350,30/12/2016,DD,UCU B ACCOUNT,22.7,,18726.72,Others,Swansea,UK
5351,29/12/2016,BP,SAVE THE CHANGE,0.05,,18749.42,Savings,Swansea,UK
5352,28/12/2016,DEB,Amazon UK Marketpl,139.95,,18749.47,Amazon,Swansea,UK
5353,28/12/2016,FPI,MARIANA MILLS,,250.0,18889.42,Supplementary Income,Swansea,UK
5354,22/12/2016,DD,CORGI HOMEPLAN CA,19.5,,18639.42,Home Improvement,Swansea,UK
5355,22/12/2016,BP,SAVE THE CHANGE,0.4,,18658.92,Savings,Swansea,UK
5356,22/12/2016,BGC,SWANSEA UNIVERSITY,,1048.42,18659.32,Supplementary Income,Swansea,UK
5357,21/12/2016,DEB,ARRIVA TRAINS WALE,72.6,,17610.9,Travel,,
5358,21/12/2016,DD,VIRGIN MEDIA PYMTS,31.48,,17683.5,Bills,Nottingham,UK
5359,21/12/2016,BP,SAVE THE CHANGE,1.18,,17714.98,Savings,Swansea,UK
5360,20/12/2016,DEB,POST OFFICE COUNTE,4.84,,17716.16,Others,Swansea,UK
5361,20/12/2016,DEB,Amazon UK Marketpl,4.29,,17721.0,Amazon,Swansea,UK
5362,20/12/2016,DEB,Amazon UK Marketpl,2.69,,17725.29,Amazon,Swansea,UK
5363,20/12/2016,BP,SAVE THE CHANGE,0.54,,17727.98,Savings,Swansea,UK
5364,19/12/2016,DEB,Amazon UK Marketpl,26.46,,17728.52,Amazon,Swansea,UK
5365,19/12/2016,CPT,LNK UNI - UNIVERSI,100.0,,17754.98,Cash,Swansea,UK
5366,19/12/2016,BP,SAVE THE CHANGE,0.28,,17854.98,Savings,Swansea,UK
5367,19/12/2016,BGC,SWANSEA UNI - PAY,,3112.59,17855.26,Paycheck,Swansea,UK
5368,16/12/2016,DEB,AMAZON UK RETAIL A,9.72,,14742.67,Amazon,Swansea,UK
5369,16/12/2016,CPT,LNK UNI - UNIVERSI,50.0,,14752.39,Cash,Swansea,UK
5370,16/12/2016,DD,O2,17.41,,14802.39,Other Shopping,Swansea,UK
5371,16/12/2016,BP,SAVE THE CHANGE,0.85,,14819.8,Savings,Swansea,UK
5372,15/12/2016,DEB,Amazon UK Marketpl,16.15,,14820.65,Amazon,Swansea,UK
5373,14/12/2016,BP,SAVE THE CHANGE,0.37,,14836.8,Savings,Swansea,UK
5374,13/12/2016,DEB,Amazon UK Marketpl,3.63,,14837.17,Amazon,Swansea,UK
5375,13/12/2016,FPI,MARIANA MILLS,,300.0,14840.8,Supplementary Income,Swansea,UK
5376,13/12/2016,CPT,LNK UNI - UNIVERSI,50.0,,14540.8,Cash,Swansea,UK
5377,13/12/2016,BP,SAVE THE CHANGE,0.87,,14590.8,Savings,Swansea,UK
5378,2016-12-12 00:00:00,DEB,Amazon UK Retail,13.79,,14591.67,Amazon,Swansea,UK
5379,2016-12-12 00:00:00,DEB,Amazon UK Marketpl,3.45,,14605.46,Amazon,Swansea,UK
5380,2016-12-12 00:00:00,DEB,AMAZON UK RETAIL A,9.99,,14608.91,Amazon,Swansea,UK
5381,2016-12-12 00:00:00,DEB,Amazon UK Retail,9.9,,14618.9,Amazon,Swansea,UK
5382,2016-09-12 00:00:00,CPT,LOYD TALIESIN BUIL,50.0,,14628.8,Cash,,
5383,2016-09-12 00:00:00,DD,LV LIFE,37.12,,14678.8,Insurance,Swansea,UK
5384,2016-09-12 00:00:00,BP,SAVE THE CHANGE,0.97,,14715.92,Savings,Swansea,UK
5385,2016-08-12 00:00:00,DEB,Amazon UK Marketpl,20.03,,14716.89,Amazon,Swansea,UK
5386,2016-08-12 00:00:00,DEB,AMAZON UK RETAIL A,,7.0,14736.92,Supplementary Income,Swansea,UK
5387,2016-07-12 00:00:00,CPT,LNK UNI - UNIVERSI,40.0,,14729.92,Cash,Swansea,UK
5388,2016-07-12 00:00:00,BP,SAVE THE CHANGE,1.39,,14769.92,Savings,Swansea,UK
5389,2016-06-12 00:00:00,DEB,AMAZON UK RETAIL A,88.9,,14771.31,Amazon,Swansea,UK
5390,2016-06-12 00:00:00,DEB,AMAZON MKTPLACE PM,29.34,,14860.21,Amazon,Swansea,UK
5391,2016-06-12 00:00:00,DEB,AMAZON.DE PAYMENTS,16.56,,14889.55,Amazon,Swansea,UK
5392,2016-06-12 00:00:00,DEB,AMAZON MKTPLACE PM,7.81,,14906.11,Amazon,Swansea,UK
5393,2016-06-12 00:00:00,CPT,LNK UNI - UNIVERSI,40.0,,14913.92,Cash,Swansea,UK
5394,2016-05-12 00:00:00,DD,ASSURANT INTER LTD,39.74,,14953.92,Insurance,Swansea,UK
5395,2016-05-12 00:00:00,BP,SAVE THE CHANGE,0.56,,14993.66,Savings,Swansea,UK
5396,2016-02-12 00:00:00,DEB,Amazon *Mktplce EU,96.95,,14994.22,Amazon,Swansea,UK
5397,2016-02-12 00:00:00,DEB,Amazon UK Marketpl,18.49,,15091.17,Amazon,Swansea,UK
5398,2016-02-12 00:00:00,CPT,LNK UNI - UNIVERSI,50.0,,15109.66,Cash,Swansea,UK
5399,2016-01-12 00:00:00,FEE,ACCOUNT FEE,9.95,,15159.66,Bills,Swansea,UK
5400,2016-01-12 00:00:00,DD,NATWEST BANK,828.49,,15169.61,Mortgage,Swansea,UK
5401,2016-01-12 00:00:00,DD,CC SWANSEA C.TAX,233.0,,15998.1,Bills,Swansea,UK
5402,2016-01-12 00:00:00,DD,GOOD ENERGY GAS,43.0,,16231.1,Bills,Swansea,UK
5403,2016-01-12 00:00:00,DD,GOOD ENERGY LTD,42.0,,16274.1,Bills,Swansea,UK
5404,2016-01-12 00:00:00,DD,DWR CYMRU W WATER,32.5,,16316.1,Bills,Swansea,UK
5405,2016-01-12 00:00:00,DD,TV LICENCE MBP,12.18,,16348.6,Bills,Swansea,UK
5406,2016-01-12 00:00:00,SO,ESAVINGS ACCOUNT,300.0,,16360.78,Savings,Swansea,UK
5407,2016-01-12 00:00:00,BP,SAVE THE CHANGE,0.6,,16660.78,Savings,Swansea,UK
5408,30/11/2016,DEB,ARRIVA TRAINS WALE,56.4,,16661.38,Travel,,
5409,30/11/2016,DD,UCU B ACCOUNT,22.7,,16717.78,Others,Swansea,UK
5410,30/11/2016,BP,SAVE THE CHANGE,0.6,,16740.48,Savings,Swansea,UK
5411,30/11/2016,BGC,SWANSEA UNI - PAY,,3112.59,16741.08,Paycheck,Swansea,UK
5412,29/11/2016,CPT,LNK ARRIVA TRAINS,80.0,,13628.49,Cash,,
5413,29/11/2016,DEB,ARRIVA TRAINS WALE,56.4,,13708.49,Travel,,
5414,29/11/2016,BP,SAVE THE CHANGE,0.1,,13764.89,Savings,Swansea,UK
5415,28/11/2016,DEB,Amazon UK Marketpl,12.9,,13764.99,Amazon,Swansea,UK
5416,28/11/2016,CPT,LNK ARRIVA TRAINS,80.0,,13777.89,Cash,,
5417,28/11/2016,BP,SAVE THE CHANGE,0.35,,13857.89,Savings,Swansea,UK
5418,28/11/2016,FPI,MARIANA MILLS,,25.0,13858.24,Supplementary Income,Swansea,UK
5419,25/11/2016,DEB,JS ONLINE GROCERY,322.65,,13833.24,Groceries,Swansea,UK
5420,25/11/2016,CPT,LNK UNI - UNIVERSI,50.0,,14155.89,Cash,Swansea,UK
5421,24/11/2016,BP,SAVE THE CHANGE,0.02,,14205.89,Savings,Swansea,UK
5422,23/11/2016,DEB,Amazon UK Marketpl,39.99,,14205.91,Amazon,Swansea,UK
5423,23/11/2016,DEB,AMAZON UK RETAIL A,10.99,,14245.9,Amazon,Swansea,UK
5424,23/11/2016,CPT,LNK UNI - UNIVERSI,50.0,,14256.89,Cash,Swansea,UK
5425,23/11/2016,BP,SAVE THE CHANGE,1.58,,14306.89,Savings,Swansea,UK
5426,22/11/2016,DEB,Amazon UK Marketpl,408.45,,14308.47,Amazon,Swansea,UK
5427,22/11/2016,DEB,Amazon UK Marketpl,9.49,,14716.92,Amazon,Swansea,UK
5428,22/11/2016,DEB,SUSU TRADING LTD,54.48,,14726.41,Home Improvement,Swansea,UK
5429,22/11/2016,DD,CORGI HOMEPLAN CA,19.5,,14780.89,Home Improvement,Swansea,UK
5430,22/11/2016,BP,SAVE THE CHANGE,0.86,,14800.39,Savings,Swansea,UK
5431,21/11/2016,DEB,Amazon UK Marketpl,42.98,,14801.25,Amazon,Swansea,UK
5432,21/11/2016,DEB,Amazon UK Marketpl,23.99,,14844.23,Amazon,Swansea,UK
5433,21/11/2016,DEB,Amazon UK Marketpl,8.17,,14868.22,Amazon,Swansea,UK
5434,21/11/2016,CPT,LNK UNI - UNIVERSI,50.0,,14876.39,Cash,Swansea,UK
5435,21/11/2016,DD,VIRGIN MEDIA PYMTS,31.48,,14926.39,Bills,Nottingham,UK
5436,21/11/2016,BP,SAVE THE CHANGE,0.05,,14957.87,Savings,Swansea,UK
5437,18/11/2016,DEB,Amazon UK Marketpl,10.95,,14957.92,Amazon,Swansea,UK
5438,16/11/2016,DD,O2,37.28,,14968.87,Other Shopping,Swansea,UK
5439,16/11/2016,BP,SAVE THE CHANGE,1.52,,15006.15,Savings,Swansea,UK
5440,15/11/2016,DEB,Amazon UK Marketpl,12.49,,15007.67,Amazon,Swansea,UK
5441,15/11/2016,DEB,Amazon Svcs Europe,8.5,,15020.16,Amazon,Swansea,UK
5442,15/11/2016,DEB,Amazon UK Marketpl,8.49,,15028.66,Amazon,Swansea,UK
5443,15/11/2016,CPT,LNK UNI - UNIVERSI,50.0,,15037.15,Cash,Swansea,UK
5444,15/11/2016,BP,SAVE THE CHANGE,0.01,,15087.15,Savings,Swansea,UK
5445,14/11/2016,DEB,WWW.ALLBAMBOOLTD.C,102.0,,15087.16,Home Improvement,Swansea,UK
5446,14/11/2016,DEB,Amazon UK Retail,5.99,,15189.16,Amazon,Swansea,UK
5447,14/11/2016,FPI,MARIANA MILLS 13NOV16,,130.0,15195.15,Supplementary Income,Swansea,UK
5448,2016-11-11 00:00:00,CPT,LOYD TALIESIN BUIL,50.0,,15065.15,Cash,,
5449,2016-11-11 00:00:00,CHQ,47,320.0,,15115.15,Cash,,
5450,2016-09-11 00:00:00,DD,LV LIFE,37.12,,15435.15,Insurance,Swansea,UK
5451,2016-09-11 00:00:00,BP,SAVE THE CHANGE,1.04,,15472.27,Savings,Swansea,UK
5452,2016-08-11 00:00:00,DEB,Amazon UK Retail,11.45,,15473.31,Amazon,Swansea,UK
5453,2016-08-11 00:00:00,DEB,AMAZON MKTPLACE PM,6.51,,15484.76,Amazon,Swansea,UK
5454,2016-08-11 00:00:00,CPT,LNK FULTON HOUSE,50.0,,15491.27,Cash,Swansea,UK
5455,2016-08-11 00:00:00,BP,SAVE THE CHANGE,0.96,,15541.27,Savings,Swansea,UK
5456,2016-07-11 00:00:00,DEB,Amazon Svcs Europe,14.04,,15542.23,Amazon,Swansea,UK
5457,2016-07-11 00:00:00,BP,SAVE THE CHANGE,0.8,,15556.27,Savings,Swansea,UK
5458,2016-04-11 00:00:00,DEB,SWANSEA UNI - CATE,4.2,,15557.07,Dine Out,Swansea,UK
5459,2016-04-11 00:00:00,CPT,LOYD WALES UNIV SW,20.0,,15561.27,Cash,Swansea,UK
5460,2016-03-11 00:00:00,CPT,LOYD WALES UNIV SW,50.0,,15581.27,Cash,Swansea,UK
5461,2016-03-11 00:00:00,DD,ASSURANT INTER LTD,39.74,,15631.27,Insurance,Swansea,UK
5462,2016-03-11 00:00:00,BP,SAVE THE CHANGE,0.44,,15671.01,Savings,Swansea,UK
5463,2016-02-11 00:00:00,DEB,Amazon UK Marketpl,27.56,,15671.45,Amazon,Swansea,UK
5464,2016-02-11 00:00:00,BP,SAVE THE CHANGE,0.78,,15699.01,Savings,Swansea,UK
5465,2016-01-11 00:00:00,FEE,ACCOUNT FEE,9.95,,15699.79,Bills,Swansea,UK
5466,2016-01-11 00:00:00,FPI,MARIANA MILLS,,250.0,15709.74,Supplementary Income,Swansea,UK
5467,2016-01-11 00:00:00,DD,NATWEST BANK,828.49,,15459.74,Mortgage,Swansea,UK
5468,2016-01-11 00:00:00,DD,CC SWANSEA C.TAX,233.0,,16288.23,Bills,Swansea,UK
5469,2016-01-11 00:00:00,DD,GOOD ENERGY GAS,43.0,,16521.23,Bills,Swansea,UK
5470,2016-01-11 00:00:00,DD,GOOD ENERGY LTD,42.0,,16564.23,Bills,Swansea,UK
5471,2016-01-11 00:00:00,DD,DWR CYMRU W WATER,32.5,,16606.23,Bills,Swansea,UK
5472,2016-01-11 00:00:00,DD,TV LICENCE MBP,12.12,,16638.73,Bills,Swansea,UK
5473,2016-01-11 00:00:00,DEB,NON-STG PURCH FEE,1.0,,16650.85,Others,Swansea,UK
5474,2016-01-11 00:00:00,DEB,NON-STG TRANS FEE,24.49,,16651.85,Others,Swansea,UK
5475,2016-01-11 00:00:00,DEB,EMBASSY SUITES BAL,819.22,,16676.34,Travel,Baltimore,USA
5476,2016-01-11 00:00:00,SO,ESAVINGS ACCOUNT,300.0,,17495.56,Savings,Swansea,UK
5477,31/10/2016,CPT,LOYD WALES UNIV SW,50.0,,17795.56,Cash,Swansea,UK
5478,31/10/2016,DD,UCU B ACCOUNT,22.7,,17845.56,Others,Swansea,UK
5479,31/10/2016,BGC,SWANSEA UNI - PAY,,3166.96,17868.26,Paycheck,Swansea,UK
5480,28/10/2016,BP,SAVE THE CHANGE,0.06,,14701.3,Savings,Swansea,UK
5481,28/10/2016,BGC,SWANSEA UNIVERSITY,,438.85,14701.36,Supplementary Income,Swansea,UK
5482,27/10/2016,DEB,NON-STG PURCH FEE,1.0,,14262.51,Others,Swansea,UK
5483,27/10/2016,DEB,NON-STG TRANS FEE,2.45,,14263.51,Others,Swansea,UK
5484,27/10/2016,DEB,SUPREME AIRPORT SH,81.94,,14265.96,Travel,,
5485,25/10/2016,BP,SAVE THE CHANGE,0.43,,14347.9,Savings,Swansea,UK
5486,24/10/2016,DEB,Amazon UK Marketpl,13.57,,14348.33,Amazon,Swansea,UK
5487,24/10/2016,DD,CORGI HOMEPLAN CA,19.5,,14361.9,Home Improvement,Swansea,UK
5488,24/10/2016,BP,SAVE THE CHANGE,0.04,,14381.4,Savings,Swansea,UK
5489,24/10/2016,BGC,SWANSEA UNIVERSITY,,335.33,14381.44,Supplementary Income,Swansea,UK
5490,21/10/2016,DEB,EASYJET   ERB813,645.96,,14046.11,Travel,,
5491,21/10/2016,CPT,LOYD WALES UNIV SW,70.0,,14692.07,Cash,Swansea,UK
5492,21/10/2016,DD,VIRGIN MEDIA PYMTS,27.99,,14762.07,Bills,Nottingham,UK
5493,21/10/2016,BP,SAVE THE CHANGE,0.02,,14790.06,Savings,Swansea,UK
5494,20/10/2016,FPI,MARIANA MILLS,,340.0,14790.08,Supplementary Income,Swansea,UK
5495,20/10/2016,DEB,Amazon UK Marketpl,10.98,,14450.08,Amazon,Swansea,UK
5496,20/10/2016,CPT,LOYD WALES UNIV SW,80.0,,14461.06,Cash,Swansea,UK
5497,20/10/2016,BP,SAVE THE CHANGE,0.94,,14541.06,Savings,Swansea,UK
5498,19/10/2016,DEB,SUSU TRADING LTD,52.84,,14542.0,Home Improvement,Swansea,UK
5499,19/10/2016,DEB,Amazon *Mktplce EU,11.22,,14594.84,Cash,Swansea,UK
5500,18/10/2016,BP,SAVE THE CHANGE,0.97,,14606.06,Savings,Swansea,UK
5501,17/10/2016,DEB,Amazon UK Retail,30.43,,14607.03,Amazon,Swansea,UK
5502,17/10/2016,DEB,Audible.co.uk,14.6,,14637.46,Entertainment,,
5503,17/10/2016,DEB,EC GIFTWARE LTD,,6.65,14652.06,Supplementary Income,Swansea,UK
5504,17/10/2016,DD,O2,33.12,,14645.41,Other Shopping,Swansea,UK
5505,17/10/2016,BP,SAVE THE CHANGE,1.99,,14678.53,Savings,Swansea,UK
5506,14/10/2016,DEB,Amazon UK Marketpl,14.01,,14680.52,Amazon,Swansea,UK
5507,14/10/2016,DEB,Amazon UK Marketpl,11.49,,14694.53,Amazon,Swansea,UK
5508,14/10/2016,DEB,EC GIFTWARE LTD,72.51,,14706.02,Other Shopping,,
5509,14/10/2016,CPT,LOYD WALES UNIV SW,40.0,,14778.53,Cash,Swansea,UK
5510,2016-11-10 00:00:00,BP,SAVE THE CHANGE,1.07,,14818.53,Savings,Swansea,UK
5511,2016-10-10 00:00:00,DEB,Amazon UK Marketpl,22.99,,14819.6,Amazon,Swansea,UK
5512,2016-10-10 00:00:00,DEB,Amazon UK Marketpl,29.44,,14842.59,Amazon,Swansea,UK
5513,2016-10-10 00:00:00,DEB,Amazon UK Marketpl,8.5,,14872.03,Amazon,Swansea,UK
5514,2016-10-10 00:00:00,CPT,LOYD WALES UNIV SW,30.0,,14880.53,Cash,Swansea,UK
5515,2016-10-10 00:00:00,DD,LV LIFE,37.12,,14910.53,Insurance,Swansea,UK
5516,2016-10-10 00:00:00,BP,SAVE THE CHANGE,1.05,,14947.65,Savings,Swansea,UK
5517,2016-07-10 00:00:00,DEB,AMAZON UK RETAIL A,10.19,,14948.7,Amazon,Swansea,UK
5518,2016-07-10 00:00:00,DEB,Amazon Svcs Europe,8.76,,14958.89,Amazon,Swansea,UK
5519,2016-07-10 00:00:00,CPT,LOYD WALES UNIV SW,20.0,,14967.65,Cash,Swansea,UK
5520,2016-07-10 00:00:00,CHQ,46,40.0,,14987.65,Cash,,
5521,2016-06-10 00:00:00,FPI,MARIANA MILLS,,250.0,15027.65,Supplementary Income,Swansea,UK
5522,2016-06-10 00:00:00,CPT,LOYD WALES UNIV SW,40.0,,14777.65,Cash,Swansea,UK
5523,2016-05-10 00:00:00,BP,SAVE THE CHANGE,0.83,,14817.65,Savings,Swansea,UK
5524,2016-04-10 00:00:00,DEB,Amazon UK Marketpl,9.98,,14818.48,Amazon,Swansea,UK
5525,2016-04-10 00:00:00,DEB,Amazon UK Marketpl,9.94,,14828.46,Amazon,Swansea,UK
5526,2016-04-10 00:00:00,DEB,Amazon UK Marketpl,4.25,,14838.4,Amazon,Swansea,UK
5527,2016-04-10 00:00:00,BP,SAVE THE CHANGE,0.47,,14842.65,Savings,Swansea,UK
5528,2016-03-10 00:00:00,FEE,ACCOUNT FEE,9.95,,14843.12,Bills,Swansea,UK
5529,2016-03-10 00:00:00,DEB,Amazon UK Marketpl,38.53,,14853.07,Amazon,Swansea,UK
5530,2016-03-10 00:00:00,DEB,Amazon UK Marketpl,165.0,,14891.6,Amazon,Swansea,UK
5531,2016-03-10 00:00:00,DD,NATWEST BANK,828.49,,15056.6,Mortgage,Swansea,UK
5532,2016-03-10 00:00:00,DD,CC SWANSEA C.TAX,231.81,,15885.09,Bills,Swansea,UK
5533,2016-03-10 00:00:00,DD,GOOD ENERGY GAS,43.0,,16116.9,Bills,Swansea,UK
5534,2016-03-10 00:00:00,DD,GOOD ENERGY LTD,42.0,,16159.9,Bills,Swansea,UK
5535,2016-03-10 00:00:00,DD,ASSURANT INTER LTD,39.74,,16201.9,Insurance,Swansea,UK
5536,2016-03-10 00:00:00,DD,DWR CYMRU W WATER,29.5,,16241.64,Bills,Swansea,UK
5537,2016-03-10 00:00:00,DD,TV LICENCE MBP,12.12,,16271.14,Bills,Swansea,UK
5538,2016-03-10 00:00:00,SO,ESAVINGS ACCOUNT,300.0,,16283.26,Savings,Swansea,UK
5539,2016-03-10 00:00:00,BP,SAVE THE CHANGE,0.85,,16583.26,Savings,Swansea,UK
5540,30/09/2016,DEB,JS ONLINE GROCERY,194.15,,16584.11,Groceries,Swansea,UK
5541,30/09/2016,DEB,JS ONLINE GROCERY,,3.0,16778.26,Supplementary Income,Swansea,UK
5542,30/09/2016,CPT,LOYD WALES UNIV SW,30.0,,16775.26,Cash,Swansea,UK
5543,30/09/2016,DD,UCU B ACCOUNT,22.7,,16805.26,Others,Swansea,UK
5544,30/09/2016,BGC,SWANSEA UNI - PAY,,3085.63,16827.96,Paycheck,Swansea,UK
5545,29/09/2016,BP,SAVE THE CHANGE,1.69,,13742.33,Savings,Swansea,UK
5546,28/09/2016,DEB,Amazon UK Marketpl,22.99,,13744.02,Amazon,Swansea,UK
5547,28/09/2016,DEB,PIZZA EXPRESS,20.3,,13767.01,Dine Out,,
5548,28/09/2016,DEB,Amazon Svcs Europe,7.02,,13787.31,Amazon,Swansea,UK
5549,28/09/2016,CPT,LOYD WALES UNIV SW,50.0,,13794.33,Cash,Swansea,UK
5550,28/09/2016,BP,SAVE THE CHANGE,1.39,,13844.33,Savings,Swansea,UK
5551,27/09/2016,DEB,HILTON,265.0,,13845.72,Hotels,,
5552,27/09/2016,DEB,ARRIVA TRAINS WALE,116.8,,14110.72,Travel,,
5553,27/09/2016,DEB,ARRIVA TRAINS WALE,113.8,,14227.52,Travel,,
5554,27/09/2016,DEB,Amazon UK Marketpl,13.54,,14341.32,Amazon,Swansea,UK
5555,27/09/2016,DEB,SKR*ETHICAL PETS,28.47,,14354.86,Other Shopping,,
5556,27/09/2016,DEB,ARRIVA TRAINS WALE,,113.8,14383.33,Supplementary Income,Swansea,UK
5557,27/09/2016,BP,SAVE THE CHANGE,1.14,,14269.53,Savings,Swansea,UK
5558,26/09/2016,DEB,Amazon UK Retail,10.74,,14270.67,Amazon,Swansea,UK
5559,26/09/2016,DEB,Amazon UK Marketpl,1.83,,14281.41,Amazon,Swansea,UK
5560,26/09/2016,DEB,Amazon UK Marketpl,12.29,,14283.24,Amazon,Swansea,UK
5561,26/09/2016,CPT,LNK ARRIVA TRAINS,50.0,,14295.53,Cash,,
5562,23/09/2016,BP,SAVE THE CHANGE,0.53,,14345.53,Savings,Swansea,UK
5563,22/09/2016,DEB,AMAZON UK RETAIL A,159.98,,14346.06,Amazon,Swansea,UK
5564,22/09/2016,DEB,AMAZON UK RETAIL A,19.49,,14506.04,Amazon,Swansea,UK
5565,22/09/2016,DD,CORGI HOMEPLAN CA,19.5,,14525.53,Home Improvement,Swansea,UK
5566,22/09/2016,BP,SAVE THE CHANGE,0.04,,14545.03,Savings,Swansea,UK
5567,21/09/2016,DEB,AMAZON UK RETAIL A,129.96,,14545.07,Amazon,Swansea,UK
5568,21/09/2016,DD,VIRGIN MEDIA PYMTS,27.99,,14675.03,Bills,Nottingham,UK
5569,21/09/2016,BP,SAVE THE CHANGE,0.05,,14703.02,Savings,Swansea,UK
5570,20/09/2016,DEB,Amazon UK Marketpl,16.99,,14703.07,Amazon,Swansea,UK
5571,20/09/2016,DEB,Amazon UK Marketpl,14.96,,14720.06,Amazon,Swansea,UK
5572,16/09/2016,DD,O2,24.21,,14735.02,Other Shopping,Swansea,UK
5573,14/09/2016,BP,SAVE THE CHANGE,0.05,,14759.23,Savings,Swansea,UK
5574,13/09/2016,DEB,Amazon UK Marketpl,36.95,,14759.28,Amazon,Swansea,UK
5575,13/09/2016,BP,SAVE THE CHANGE,0.28,,14796.23,Savings,Swansea,UK
5576,2016-12-09 00:00:00,DEB,Amazon UK Marketpl,9.72,,14796.51,Amazon,Swansea,UK
5577,2016-12-09 00:00:00,BP,SAVE THE CHANGE,0.42,,14806.23,Savings,Swansea,UK
5578,2016-12-09 00:00:00,FPI,MARIANA MILLS,,150.0,14806.65,Supplementary Income,Swansea,UK
5579,2016-09-09 00:00:00,DEB,Amazon UK Marketpl,37.99,,14656.65,Amazon,Swansea,UK
5580,2016-09-09 00:00:00,DEB,Amazon UK Marketpl,9.89,,14694.64,Amazon,Swansea,UK
5581,2016-09-09 00:00:00,DEB,AMAZON UK RETAIL A,21.7,,14704.53,Amazon,Swansea,UK
5582,2016-09-09 00:00:00,CPT,LOYD WALES UNIV SW,50.0,,14726.23,Cash,Swansea,UK
5583,2016-09-09 00:00:00,DD,LV LIFE,37.12,,14776.23,Insurance,Swansea,UK
5584,2016-09-09 00:00:00,BP,SAVE THE CHANGE,0.61,,14813.35,Savings,Swansea,UK
5585,2016-08-09 00:00:00,DEB,Amazon UK Marketpl,14.95,,14813.96,Amazon,Swansea,UK
5586,2016-08-09 00:00:00,DEB,Amazon UK Marketpl,9.9,,14828.91,Amazon,Swansea,UK
5587,2016-08-09 00:00:00,DEB,Amazon UK Marketpl,5.54,,14838.81,Amazon,Swansea,UK
5588,2016-06-09 00:00:00,BP,SAVE THE CHANGE,0.75,,14844.35,Savings,Swansea,UK
5589,2016-05-09 00:00:00,DEB,NON-STG PURCH FEE,1.0,,14845.1,Others,Swansea,UK
5590,2016-05-09 00:00:00,DEB,NON-STG TRANS FEE,1.77,,14846.1,Others,Swansea,UK
5591,2016-05-09 00:00:00,DEB,TERRA RESTAURANTE,59.25,,14847.87,Dine Out,Porto,Portugal
5592,2016-05-09 00:00:00,DD,ASSURANT INTER LTD,39.85,,14907.12,Insurance,Swansea,UK
5593,2016-05-09 00:00:00,BP,SAVE THE CHANGE,0.4,,14946.97,Savings,Swansea,UK
5594,2016-02-09 00:00:00,DEB,ARRIVA TRAINS WALE,72.6,,14947.37,Travel,,
5595,2016-01-09 00:00:00,FEE,ACCOUNT FEE,9.95,,15019.97,Bills,Swansea,UK
5596,2016-01-09 00:00:00,DD,NATWEST BANK,828.49,,15029.92,Mortgage,Swansea,UK
5597,2016-01-09 00:00:00,DD,CC SWANSEA C.TAX,127.0,,15858.41,Bills,Swansea,UK
5598,2016-01-09 00:00:00,DD,GOOD ENERGY GAS,43.0,,15985.41,Bills,Swansea,UK
5599,2016-01-09 00:00:00,DD,GOOD ENERGY LTD,42.0,,16028.41,Bills,Swansea,UK
5600,2016-01-09 00:00:00,DD,DWR CYMRU W WATER,29.5,,16070.41,Bills,Swansea,UK
5601,2016-01-09 00:00:00,DD,TV LICENCE MBP,12.12,,16099.91,Bills,Swansea,UK
5602,2016-01-09 00:00:00,SO,ESAVINGS ACCOUNT,300.0,,16112.03,Savings,Swansea,UK
5603,2016-01-09 00:00:00,BP,SAVE THE CHANGE,0.67,,16412.03,Savings,Swansea,UK
5604,31/08/2016,DEB,Amazon UK Marketpl,19.33,,16412.7,Amazon,Swansea,UK
5605,31/08/2016,BP,SAVE THE CHANGE,0.47,,16432.03,Savings,Swansea,UK
5606,31/08/2016,BGC,SWANSEA UNI - PAY,,3085.63,16432.5,Paycheck,Swansea,UK
5607,30/08/2016,DEB,Amazon UK Marketpl,19.99,,13346.87,Amazon,Swansea,UK
5608,30/08/2016,DEB,Amazon UK Marketpl,13.96,,13366.86,Amazon,Swansea,UK
5609,30/08/2016,DEB,Amazon UK Marketpl,13.58,,13380.82,Amazon,Swansea,UK
5610,30/08/2016,CPT,LOYD WALES UNIV SW,30.0,,13394.4,Cash,Swansea,UK
5611,30/08/2016,BP,SAVE THE CHANGE,0.22,,13424.4,Savings,Swansea,UK
5612,30/08/2016,CPT,LNK UNION STREET,30.0,,13424.62,Cash,,
5613,26/08/2016,DEB,Amazon UK Marketpl,6.78,,13454.62,Amazon,Swansea,UK
5614,26/08/2016,CPT,LOYD WALES UNIV SW,30.0,,13461.4,Cash,Swansea,UK
5615,26/08/2016,DD,UCU B ACCOUNT,22.37,,13491.4,Others,Swansea,UK
5616,26/08/2016,BP,SAVE THE CHANGE,1.21,,13513.77,Savings,Swansea,UK
5617,25/08/2016,DEB,Amazon UK Marketpl,5.16,,13514.98,Amazon,Swansea,UK
5618,25/08/2016,DEB,AMAZON UK RETAIL A,3.63,,13520.14,Amazon,Swansea,UK
5619,25/08/2016,FPO,FB EDMUNDS,31.25,,13523.77,,,
5620,25/08/2016,BP,SAVE THE CHANGE,1.03,,13555.02,Savings,Swansea,UK
5621,24/08/2016,DEB,Amazon UK Marketpl,89.99,,13556.05,Amazon,Swansea,UK
5622,24/08/2016,DEB,Amazon UK Marketpl,21.25,,13646.04,Amazon,Swansea,UK
5623,24/08/2016,DEB,AMAZON UK RETAIL A,13.73,,13667.29,Amazon,Swansea,UK
5624,24/08/2016,DEB,Amazon UK Marketpl,,17.99,13681.02,Supplementary Income,Swansea,UK
5625,24/08/2016,CPT,LOYD WALES UNIV SW,50.0,,13663.03,Cash,Swansea,UK
5626,24/08/2016,BP,SAVE THE CHANGE,0.29,,13713.03,Savings,Swansea,UK
5627,23/08/2016,DEB,Amazon UK Marketpl,9.72,,13713.32,Amazon,Swansea,UK
5628,23/08/2016,DEB,Amazon UK Marketpl,8.99,,13723.04,Amazon,Swansea,UK
5629,23/08/2016,BP,SAVE THE CHANGE,1.43,,13732.03,Savings,Swansea,UK
5630,22/08/2016,DEB,Amazon UK Marketpl,11.38,,13733.46,Amazon,Swansea,UK
5631,22/08/2016,DEB,Amazon UK Retail,58.2,,13744.84,Amazon,Swansea,UK
5632,22/08/2016,DEB,Amazon UK Marketpl,49.99,,13803.04,Amazon,Swansea,UK
5633,22/08/2016,DD,VIRGIN MEDIA PYMTS,27.99,,13853.03,Bills,Nottingham,UK
5634,22/08/2016,DD,CORGI HOMEPLAN CA,19.5,,13881.02,Home Improvement,Swansea,UK
5635,19/08/2016,FPI,MARIANA MILLS,,175.0,13900.52,Supplementary Income,Swansea,UK
5636,17/08/2016,DEB,CROWNE PLAZA,135.0,,13725.52,Hotels,,
5637,17/08/2016,BP,SAVE THE CHANGE,0.2,,13860.52,Savings,Swansea,UK
5638,16/08/2016,DEB,CROWNE PLAZA,25.8,,13860.72,Hotels,,
5639,16/08/2016,DD,O2,17.32,,13886.52,Other Shopping,Swansea,UK
5640,16/08/2016,BP,SAVE THE CHANGE,1.0,,13903.84,Savings,Swansea,UK
5641,15/08/2016,DEB,JS ONLINE GROCERY,368.5,,13904.84,Groceries,Swansea,UK
5642,15/08/2016,DEB,Amazon UK Marketpl,17.99,,14273.34,Amazon,Swansea,UK
5643,15/08/2016,DEB,GWR WEBSALES ECOM,137.0,,14291.33,Travel,,
5644,15/08/2016,DEB,AMAZON UK RETAIL A,99.51,,14428.33,Amazon,Swansea,UK
5645,15/08/2016,CPT,LNK ARRIVA TRAINS,50.0,,14527.84,Cash,,
5646,15/08/2016,BP,SAVE THE CHANGE,0.1,,14577.84,Savings,Swansea,UK
5647,2016-12-08 00:00:00,DEB,Amazon UK Marketpl,16.9,,14577.94,Amazon,Swansea,UK
5648,2016-12-08 00:00:00,CPT,LOYD WALES UNIV SW,50.0,,14594.84,Amazon,Swansea,UK
5649,2016-09-08 00:00:00,BP,SAVE THE CHANGE,0.19,,14644.84,Savings,Swansea,UK
5650,2016-08-08 00:00:00,DEB,Amazon UK Marketpl,2.81,,14645.03,Amazon,Swansea,UK
5651,2016-08-08 00:00:00,DD,LV LIFE,37.12,,14647.84,Insurance,Swansea,UK
5652,2016-05-08 00:00:00,BP,SAVE THE CHANGE,1.03,,14684.96,Savings,Swansea,UK
5653,2016-04-08 00:00:00,DEB,Amazon UK Marketpl,13.89,,14685.99,Amazon,Swansea,UK
5654,2016-04-08 00:00:00,DEB,NON-STG PURCH FEE,1.0,,14699.88,Others,Swansea,UK
5655,2016-04-08 00:00:00,DEB,NON-STG TRANS FEE,0.18,,14700.88,Others,Swansea,UK
5656,2016-04-08 00:00:00,DEB,KLM NETHERLA074821,6.08,,14701.06,Travel,,
5657,2016-03-08 00:00:00,DD,ASSURANT INTER LTD,35.56,,14707.14,Insurance,Swansea,UK
5658,2016-02-08 00:00:00,BP,SAVE THE CHANGE,0.52,,14742.7,Savings,Swansea,UK
5659,2016-02-08 00:00:00,BGC,SWANSEA UNIVERSITY,,1652.84,14743.22,Supplementary Income,Swansea,UK
5660,2016-01-08 00:00:00,FEE,ACCOUNT FEE,9.95,,13090.38,Bills,Swansea,UK
5661,2016-01-08 00:00:00,DEB,Amazon UK Marketpl,9.48,,13100.33,Amazon,Swansea,UK
5662,2016-01-08 00:00:00,CPT,LOYD WALES UNIV SW,100.0,,13109.81,Cash,Swansea,UK
5663,2016-01-08 00:00:00,DD,NATWEST BANK,828.49,,13209.81,Mortgage,Swansea,UK
5664,2016-01-08 00:00:00,DD,CC SWANSEA C.TAX,127.0,,14038.3,Bills,Swansea,UK
5665,2016-01-08 00:00:00,DD,GOOD ENERGY GAS,43.0,,14165.3,Bills,Swansea,UK
5666,2016-01-08 00:00:00,DD,DWR CYMRU W WATER,29.5,,14208.3,Bills,Swansea,UK
5667,2016-01-08 00:00:00,DD,GOOD ENERGY LTD,13.0,,14237.8,Bills,Swansea,UK
5668,2016-01-08 00:00:00,DD,TV LICENCE MBP,12.12,,14250.8,Bills,Swansea,UK
5669,2016-01-08 00:00:00,SO,ESAVINGS ACCOUNT,300.0,,14262.92,Savings,Swansea,UK
5670,2016-01-08 00:00:00,BP,SAVE THE CHANGE,0.52,,14562.92,Savings,Swansea,UK
5671,29/07/2016,DEB,Amazon UK Marketpl,16.48,,14563.44,Amazon,Swansea,UK
5672,29/07/2016,CPT,LOYD WALES UNIV SW,50.0,,14579.92,Cash,Swansea,UK
5673,29/07/2016,DD,UCU B ACCOUNT,22.37,,14629.92,Others,Swansea,UK
5674,29/07/2016,BP,SAVE THE CHANGE,0.6,,14652.29,Savings,Swansea,UK
5675,29/07/2016,BGC,SWANSEA UNI - PAY,,3085.64,14652.89,Paycheck,Swansea,UK
5676,28/07/2016,DEB,Amazon UK Retail,16.74,,11567.25,Amazon,Swansea,UK
5677,28/07/2016,DEB,Amazon UK Marketpl,13.98,,11583.99,Amazon,Swansea,UK
5678,28/07/2016,DEB,Amazon Svcs Europe,6.68,,11597.97,Amazon,Swansea,UK
5679,28/07/2016,BP,SAVE THE CHANGE,1.32,,11604.65,Savings,Swansea,UK
5680,27/07/2016,DEB,Amazon UK Marketpl,14.22,,11605.97,Amazon,Swansea,UK
5681,27/07/2016,DEB,Amazon UK Marketpl,10.46,,11620.19,Amazon,Swansea,UK
5682,27/07/2016,CPT,LOYD WALES UNIV SW,20.0,,11630.65,Cash,Swansea,UK
5683,27/07/2016,BP,SAVE THE CHANGE,0.01,,11650.65,Savings,Swansea,UK
5684,26/07/2016,DEB,Amazon UK Marketpl,15.99,,11650.66,Amazon,Swansea,UK
5685,25/07/2016,DD,CORGI HOMEPLAN CA,19.5,,11666.65,Home Improvement,Swansea,UK
5686,25/07/2016,BP,SAVE THE CHANGE,1.38,,11686.15,Savings,Swansea,UK
5687,25/07/2016,BGC,UNIVERSITY OF EAST,,167.84,11687.53,Supplementary Income,Swansea,UK
5688,22/07/2016,DEB,Amazon UK Marketpl,18.13,,11519.69,Amazon,Swansea,UK
5689,22/07/2016,DEB,AMAZON UK RETAIL A,9.49,,11537.82,Amazon,Swansea,UK
5690,22/07/2016,CPT,LOYD WALES UNIV SW,50.0,,11547.31,Cash,Swansea,UK
5691,22/07/2016,BP,SAVE THE CHANGE,0.42,,11597.31,Savings,Swansea,UK
5692,21/07/2016,DEB,Amazon UK Retail,9.9,,11597.73,Amazon,Swansea,UK
5693,21/07/2016,DEB,Amazon UK Marketpl,8.68,,11607.63,Amazon,Swansea,UK
5694,21/07/2016,DD,VIRGIN MEDIA PYMTS,27.99,,11616.31,Bills,Nottingham,UK
5695,21/07/2016,BP,SAVE THE CHANGE,0.02,,11644.3,Savings,Swansea,UK
5696,20/07/2016,DEB,EXPEDIA 1126326416,774.98,,11644.32,Travel,,
5697,20/07/2016,BP,SAVE THE CHANGE,0.77,,12419.3,Savings,Swansea,UK
5698,19/07/2016,DEB,Amazon Svcs Europe,12.23,,12420.07,Amazon,Swansea,UK
5699,19/07/2016,BP,SAVE THE CHANGE,0.74,,12432.3,Savings,Swansea,UK
5700,18/07/2016,DEB,EASYJET   EQWFKG,383.96,,12433.04,Travel,,
5701,18/07/2016,DEB,Amazon UK Marketpl,7.3,,12817.0,Amazon,Swansea,UK
5702,18/07/2016,DD,O2,22.81,,12824.3,Other Shopping,Swansea,UK
5703,18/07/2016,BP,SAVE THE CHANGE,0.95,,12847.11,Savings,Swansea,UK
5704,18/07/2016,CPT,SBY  SWANSEA UPL C,50.0,,12848.06,Other Shopping,Swansea,UK
5705,18/07/2016,DEB,Amazon UK Marketpl,23.05,,12898.06,Amazon,Swansea,UK
5706,15/07/2016,CPT,LOYD WALES UNIV SW,50.0,,12921.11,Cash,Swansea,UK
5707,15/07/2016,BGC,SWANSEA UNIVERSITY,,858.01,12971.11,Supplementary Income,Swansea,UK
5708,14/07/2016,BP,SAVE THE CHANGE,1.23,,12113.1,Savings,Swansea,UK
5709,13/07/2016,DEB,Amazon UK Marketpl,32.29,,12114.33,Amazon,Swansea,UK
5710,13/07/2016,DEB,Amazon UK Marketpl,17.48,,12146.62,Amazon,Swansea,UK
5711,13/07/2016,CPT,LOYD WALES UNIV SW,50.0,,12164.1,Cash,Swansea,UK
5712,2016-12-07 00:00:00,CPT,LOYD WALES UNIV SW,50.0,,12214.1,Cash,Swansea,UK
5713,2016-12-07 00:00:00,BP,SAVE THE CHANGE,0.34,,12264.1,Savings,Swansea,UK
5714,2016-11-07 00:00:00,DEB,Amazon UK Marketpl,13.98,,12264.44,Amazon,Swansea,UK
5715,2016-11-07 00:00:00,DEB,Amazon UK Marketpl,8.68,,12278.42,Amazon,Swansea,UK
5716,2016-08-07 00:00:00,CPT,LOYD WALES UNIV SW,60.0,,12287.1,Cash,Swansea,UK
5717,2016-08-07 00:00:00,DD,LV LIFE,37.12,,12347.1,Insurance,Swansea,UK
5718,2016-07-07 00:00:00,DD,ASSURANT INTER LTD,35.56,,12384.22,Insurance,Swansea,UK
5719,2016-07-07 00:00:00,BP,SAVE THE CHANGE,0.71,,12419.78,Savings,Swansea,UK
5720,2016-06-07 00:00:00,FPI,MARIANA MILLS,,300.0,12420.49,Supplementary Income,Swansea,UK
5721,2016-06-07 00:00:00,DEB,NON-STG PURCH FEE,1.0,,12120.49,Others,Swansea,UK
5722,2016-06-07 00:00:00,DEB,NON-STG TRANS FEE,28.89,,12121.49,Others,Swansea,UK
5723,2016-06-07 00:00:00,DEB,ALEXANDER BEACH HO,966.29,,12150.38,Hotels,Malia,Greece
5724,2016-06-07 00:00:00,BP,SAVE THE CHANGE,0.06,,13116.67,Savings,Swansea,UK
5725,2016-05-07 00:00:00,CPT,LOYD SWANSEA UNIVE,30.0,,13116.73,Cash,Swansea,UK
5726,2016-05-07 00:00:00,DEB,Amazon UK Marketpl,39.94,,13146.73,Amazon,Swansea,UK
5727,2016-05-07 00:00:00,BP,SAVE THE CHANGE,0.67,,13186.67,Savings,Swansea,UK
5728,2016-04-07 00:00:00,DEB,Amazon UK Retail,21.33,,13187.34,Amazon,Swansea,UK
5729,2016-04-07 00:00:00,DEB,SWANSEA UNIVERSITY,1100.0,,13208.67,Others,Swansea,UK
5730,2016-04-07 00:00:00,CPT,LNK BRISTOL LANDSI,50.0,,14308.67,Cash,Bristol,UK
5731,2016-01-07 00:00:00,FEE,ACCOUNT FEE,9.95,,14358.67,Bills,Swansea,UK
5732,2016-01-07 00:00:00,DD,NATWEST BANK,828.49,,14368.62,Mortgage,Swansea,UK
5733,2016-01-07 00:00:00,DD,CC SWANSEA C.TAX,127.0,,15197.11,Bills,Swansea,UK
5734,2016-01-07 00:00:00,DD,GOOD ENERGY GAS,43.0,,15324.11,Bills,Swansea,UK
5735,2016-01-07 00:00:00,DD,DWR CYMRU W WATER,29.5,,15367.11,Bills,Swansea,UK
5736,2016-01-07 00:00:00,DD,GOOD ENERGY LTD,13.0,,15396.61,Bills,Swansea,UK
5737,2016-01-07 00:00:00,DD,TV LICENCE MBP,12.12,,15409.61,Bills,Swansea,UK
5738,2016-01-07 00:00:00,SO,ESAVINGS ACCOUNT,300.0,,15421.73,Savings,Swansea,UK
5739,30/06/2016,DD,UCU B ACCOUNT,22.37,,15721.73,Others,Swansea,UK
5740,30/06/2016,BGC,SWANSEA UNI - PAY,,3085.63,15744.1,Paycheck,Swansea,UK
5741,28/06/2016,BP,SAVE THE CHANGE,0.4,,12658.47,Savings,Swansea,UK
5742,27/06/2016,DEB,FOREIGN CASH FEE,2.87,,12658.87,Travel,,
5743,27/06/2016,DEB,Stalida-Malia,191.84,,12661.74,Travel,Malia,Greece
5744,27/06/2016,DEB,ARRIVA TRAINS WALE,72.6,,12853.58,Travel,,
5745,27/06/2016,DEB,J B PEARCE LTD,65.0,,12926.18,Travel,Bristol,
5746,24/06/2016,BP,SAVE THE CHANGE,0.51,,12991.18,Savings,Swansea,UK
5747,23/06/2016,DEB,Amazon UK Marketpl,5.49,,12991.69,Amazon,Swansea,UK
5748,23/06/2016,DD,CORGI HOMEPLAN CA,19.5,,12997.18,Home Improvement,Swansea,UK
5749,22/06/2016,BP,SAVE THE CHANGE,1.02,,13016.68,Savings,Swansea,UK
5750,21/06/2016,CPT,LNK SWANSEA WIND S,50.0,,13017.7,Cash,Swansea,UK
5751,21/06/2016,DEB,Amazon UK Retail,22.49,,13067.7,Amazon,Swansea,UK
5752,21/06/2016,DEB,Amazon UK Marketpl,15.49,,13090.19,Amazon,Swansea,UK
5753,21/06/2016,DD,VIRGIN MEDIA PYMTS,27.99,,13105.68,Bills,Nottingham,UK
5754,21/06/2016,BP,SAVE THE CHANGE,0.67,,13133.67,Savings,Swansea,UK
5755,20/06/2016,DEB,Amazon UK Marketpl,11.99,,13134.34,Amazon,Swansea,UK
5756,20/06/2016,DEB,Amazon UK Marketpl,4.34,,13146.33,Amazon,Swansea,UK
5757,20/06/2016,DEB,SKYPE SUBSCRIPTION,10.0,,13150.67,Bills,Nottingham,UK
5758,17/06/2016,CPT,LOYD WALES UNIV SW,20.0,,13160.67,Cash,Swansea,UK
5759,17/06/2016,BP,SAVE THE CHANGE,0.94,,13180.67,Savings,Swansea,UK
5760,16/06/2016,DEB,Amazon UK Marketpl,5.06,,13181.61,Amazon,Swansea,UK
5761,16/06/2016,DD,O2,16.83,,13186.67,Other Shopping,Swansea,UK
5762,15/06/2016,BP,SAVE THE CHANGE,0.64,,13203.5,Savings,Swansea,UK
5763,14/06/2016,DEB,Amazon UK Marketpl,3.36,,13204.14,Amazon,Swansea,UK
5764,14/06/2016,BP,SAVE THE CHANGE,0.43,,13207.5,Savings,Swansea,UK
5765,13/06/2016,DEB,JS ONLINE GROCERY,235.83,,13207.93,Groceries,Swansea,UK
5766,13/06/2016,DEB,Amazon UK Marketpl,26.74,,13443.76,Amazon,Swansea,UK
5767,2016-08-06 00:00:00,DD,LV LIFE,37.12,,13470.5,Insurance,Swansea,UK
5768,2016-08-06 00:00:00,DEB,NON-STG CASH FEE,2.0,,13507.62,Others,Swansea,UK
5769,2016-08-06 00:00:00,DEB,NON-STG TRANS FEE,3.54,,13509.62,Others,Swansea,UK
5770,2016-08-06 00:00:00,DEB,ING BANK,118.56,,13513.16,Others,Swansea,UK
5771,2016-07-06 00:00:00,BP,SAVE THE CHANGE,1.93,,13631.72,Savings,Swansea,UK
5772,2016-06-06 00:00:00,DEB,SCHIMMELPENNICKHUY,385.66,,13633.65,,,
5773,2016-06-06 00:00:00,DEB,NON-STG PURCH FEE,1.0,,14019.31,Others,Swansea,UK
5774,2016-06-06 00:00:00,DEB,NON-STG TRANS FEE,1.25,,14020.31,Others,Swansea,UK
5775,2016-06-06 00:00:00,DEB,NS SCHIPHOL,42.03,,14021.56,Travel,Amsterdam,Netherlands
5776,2016-06-06 00:00:00,DEB,Amazon UK Marketpl,9.75,,14063.59,Amazon,Swansea,UK
5777,2016-06-06 00:00:00,DEB,Amazon UK Marketpl,3.63,,14073.34,Amazon,Swansea,UK
5778,2016-06-06 00:00:00,BP,SAVE THE CHANGE,1.25,,14076.97,Savings,Swansea,UK
5779,2016-03-06 00:00:00,DEB,Amazon UK Marketpl,15.21,,14078.22,Amazon,Swansea,UK
5780,2016-03-06 00:00:00,DEB,Amazon UK Marketpl,5.54,,14093.43,Amazon,Swansea,UK
5781,2016-03-06 00:00:00,DD,ASSURANT INTER LTD,35.56,,14098.97,Insurance,Swansea,UK
5782,2016-03-06 00:00:00,BP,SAVE THE CHANGE,0.65,,14134.53,Savings,Swansea,UK
5783,2016-02-06 00:00:00,DEB,Amazon UK Retail,12.35,,14135.18,Amazon,Swansea,UK
5784,2016-02-06 00:00:00,BP,SAVE THE CHANGE,0.81,,14147.53,Savings,Swansea,UK
5785,2016-01-06 00:00:00,FEE,ACCOUNT FEE,9.95,,14148.34,Bills,Swansea,UK
5786,2016-01-06 00:00:00,DEB,Amazon UK Marketpl,4.2,,14158.29,Amazon,Swansea,UK
5787,2016-01-06 00:00:00,DEB,Amazon UK Marketpl,3.99,,14162.49,Amazon,Swansea,UK
5788,2016-01-06 00:00:00,DD,NATWEST BANK,828.49,,14166.48,Mortgage,Swansea,UK
5789,2016-01-06 00:00:00,DD,CC SWANSEA C.TAX,127.0,,14994.97,Bills,Swansea,UK
5790,2016-01-06 00:00:00,DD,GOOD ENERGY GAS,43.0,,15121.97,Bills,Swansea,UK
5791,2016-01-06 00:00:00,DD,DWR CYMRU W WATER,29.5,,15164.97,Bills,Swansea,UK
5792,2016-01-06 00:00:00,DD,GOOD ENERGY LTD,13.0,,15194.47,Bills,Swansea,UK
5793,2016-01-06 00:00:00,DD,TV LICENCE MBP,12.12,,15207.47,Bills,Swansea,UK
5794,2016-01-06 00:00:00,SO,ESAVINGS ACCOUNT,300.0,,15219.59,Savings,Swansea,UK
5795,2016-01-06 00:00:00,BP,SAVE THE CHANGE,0.33,,15519.59,Savings,Swansea,UK
5796,31/05/2016,DEB,EASYJET   000EQP,665.72,,15519.92,Travel,,
5797,31/05/2016,DEB,Amazon UK Marketpl,6.95,,16185.64,Amazon,Swansea,UK
5798,31/05/2016,DD,UCU B ACCOUNT,22.37,,16192.59,Others,Swansea,UK
5799,31/05/2016,BP,SAVE THE CHANGE,0.57,,16214.96,Savings,Swansea,UK
5800,31/05/2016,BGC,SWANSEA UNI - PAY,,3085.63,16215.53,Paycheck,Swansea,UK
5801,31/05/2016,CPT,LNK SWANSEA 2,50.0,,13129.9,Cash,Swansea,UK
5802,27/05/2016,DEB,ARRIVA TRAINS WALE,137.7,,13179.9,Travel,,
5803,27/05/2016,DEB,Amazon UK Marketpl,3.73,,13317.6,Amazon,Swansea,UK
5804,27/05/2016,BP,SAVE THE CHANGE,0.01,,13321.33,Savings,Swansea,UK
5805,26/05/2016,DEB,Amazon UK Marketpl,17.99,,13321.34,Amazon,Swansea,UK
5806,26/05/2016,BP,SAVE THE CHANGE,1.16,,13339.33,Savings,Swansea,UK
5807,25/05/2016,DEB,Amazon UK Marketpl,9.75,,13340.49,Amazon,Swansea,UK
5808,25/05/2016,DEB,Amazon UK Marketpl,8.09,,13350.24,Amazon,Swansea,UK
5809,25/05/2016,CPT,LOYD WALES UNIV SW,50.0,,13358.33,Cash,Swansea,UK
5810,25/05/2016,BGC,UNIVERSITY OF OXFO,,340.0,13408.33,Supplementary Income,Swansea,UK
5811,24/05/2016,BP,SAVE THE CHANGE,0.93,,13068.33,Savings,Swansea,UK
5812,23/05/2016,DEB,AMAZON MKTPLACE PM,10.9,,13069.26,Amazon,Swansea,UK
5813,23/05/2016,DEB,Amazon UK Marketpl,35.17,,13080.16,Amazon,Swansea,UK
5814,23/05/2016,DD,VIRGIN MEDIA PYMTS,27.99,,13115.33,Bills,Nottingham,UK
5815,23/05/2016,DD,CORGI HOMEPLAN CA,19.5,,13143.32,Home Improvement,Swansea,UK
5816,20/05/2016,CPT,LOYD WALES UNIV SW,50.0,,13162.82,Cash,Swansea,UK
5817,18/05/2016,CPT,LOYD WALES UNIV SW,40.0,,13212.82,Cash,Swansea,UK
5818,18/05/2016,BP,SAVE THE CHANGE,0.21,,13252.82,Savings,Swansea,UK
5819,17/05/2016,DEB,Amazon UK Marketpl,5.79,,13253.03,Amazon,Swansea,UK
5820,17/05/2016,BP,SAVE THE CHANGE,1.34,,13258.82,Savings,Swansea,UK
5821,16/05/2016,DEB,Amazon UK Retail,17.17,,13260.16,Amazon,Swansea,UK
5822,16/05/2016,DEB,Amazon UK Marketpl,11.5,,13277.33,Amazon,Swansea,UK
5823,16/05/2016,DEB,Amazon UK Retail,9.99,,13288.83,Amazon,Swansea,UK
5824,16/05/2016,DD,O2,21.82,,13298.82,Other Shopping,Swansea,UK
5825,13/05/2016,BP,SAVE THE CHANGE,0.32,,13320.64,Savings,Swansea,UK
5826,13/05/2016,BGC,SWANSEA UNIVERSITY,,1019.74,13320.96,Supplementary Income,Swansea,UK
5827,2016-12-05 00:00:00,DEB,Amazon UK Retail,7.99,,12301.22,Amazon,Swansea,UK
5828,2016-12-05 00:00:00,DEB,AMAZON MKTPLACE PM,6.69,,12309.21,Amazon,Swansea,UK
5829,2016-12-05 00:00:00,BP,SAVE THE CHANGE,0.22,,12315.9,Savings,Swansea,UK
5830,2016-11-05 00:00:00,DEB,Amazon UK Retail,17.96,,12316.12,Amazon,Swansea,UK
5831,2016-11-05 00:00:00,DEB,Amazon UK Marketpl,12.82,,12334.08,Amazon,Swansea,UK
5832,2016-11-05 00:00:00,BP,SAVE THE CHANGE,1.42,,12346.9,Savings,Swansea,UK
5833,2016-10-05 00:00:00,DEB,AMAZON MKTPLACE PM,15.1,,12348.32,Amazon,Swansea,UK
5834,2016-10-05 00:00:00,DEB,Amazon UK Marketpl,10.87,,12363.42,Amazon,Swansea,UK
5835,2016-10-05 00:00:00,DEB,Amazon UK Retail,8.97,,12374.29,Amazon,Swansea,UK
5836,2016-10-05 00:00:00,DEB,Amazon UK Marketpl,5.64,,12383.26,Amazon,Swansea,UK
5837,2016-10-05 00:00:00,BP,SAVE THE CHANGE,1.15,,12388.9,Savings,Swansea,UK
5838,2016-09-05 00:00:00,DEB,Amazon UK Marketpl,5.82,,12390.05,Amazon,Swansea,UK
5839,2016-09-05 00:00:00,DEB,Amazon UK Marketpl,2.03,,12395.87,Amazon,Swansea,UK
5840,2016-09-05 00:00:00,DD,LV LIFE,37.12,,12397.9,Insurance,Swansea,UK
5841,2016-06-05 00:00:00,FPO,JAMES DAVIES,40.0,,12435.02,Services,Swansea,UK
5842,2016-06-05 00:00:00,BP,SAVE THE CHANGE,0.7,,12475.02,Savings,Swansea,UK
5843,2016-05-05 00:00:00,FPO,JAMES DAVIES,240.0,,12475.72,Services,Swansea,UK
5844,2016-05-05 00:00:00,DEB,HAMPTON BY HILTON,99.0,,12715.72,Hotels,,
5845,2016-05-05 00:00:00,DEB,KLM UK  074174,168.3,,12814.72,Travel,,
5846,2016-05-05 00:00:00,BP,SAVE THE CHANGE,0.01,,12983.02,Savings,Swansea,UK
5847,2016-04-05 00:00:00,DEB,Amazon UK Marketpl,3.99,,12983.03,Amazon,Swansea,UK
5848,2016-04-05 00:00:00,DEB,EXPEDIA 1118747955,3.0,,12987.02,Travel,,
5849,2016-04-05 00:00:00,BP,SAVE THE CHANGE,3.55,,12990.02,Savings,Swansea,UK
5850,2016-03-05 00:00:00,FEE,ACCOUNT FEE,9.95,,12993.57,Bills,Swansea,UK
5851,2016-03-05 00:00:00,,INTEREST (GROSS),,6.33,13003.52,Interest,Swansea,UK
5852,2016-03-05 00:00:00,DEB,Amazon UK Marketpl,9.42,,12997.19,Amazon,Swansea,UK
5853,2016-03-05 00:00:00,DEB,Amazon UK Marketpl,2.0,,13006.61,Amazon,Swansea,UK
5854,2016-03-05 00:00:00,DEB,Amazon UK Marketpl,4.25,,13008.61,Amazon,Swansea,UK
5855,2016-03-05 00:00:00,DEB,Amazon UK Marketpl,3.95,,13012.86,Amazon,Swansea,UK
5856,2016-03-05 00:00:00,DEB,Amazon UK Marketpl,3.22,,13016.81,Amazon,Swansea,UK
5857,2016-03-05 00:00:00,DEB,Amazon UK Marketpl,2.27,,13020.03,Amazon,Swansea,UK
5858,2016-03-05 00:00:00,DEB,Amazon UK Retail,14.85,,13022.3,Amazon,Swansea,UK
5859,2016-03-05 00:00:00,DEB,Amazon UK Marketpl,6.49,,13037.15,Amazon,Swansea,UK
5860,2016-03-05 00:00:00,DD,NATWEST BANK,828.49,,13043.64,Mortgage,Swansea,UK
5861,2016-03-05 00:00:00,DD,CC SWANSEA C.TAX,127.0,,13872.13,Bills,Swansea,UK
5862,2016-03-05 00:00:00,DD,GOOD ENERGY GAS,43.0,,13999.13,Bills,Swansea,UK
5863,2016-03-05 00:00:00,DD,ASSURANT INTER LTD,35.56,,14042.13,Insurance,Swansea,UK
5864,2016-03-05 00:00:00,DD,DWR CYMRU W WATER,29.5,,14077.69,Bills,Swansea,UK
5865,2016-03-05 00:00:00,DD,GOOD ENERGY LTD,13.0,,14107.19,Bills,Swansea,UK
5866,2016-03-05 00:00:00,DD,TV LICENCE MBP,12.12,,14120.19,Bills,Swansea,UK
5867,2016-03-05 00:00:00,SO,ESAVINGS ACCOUNT,300.0,,14132.31,Savings,Swansea,UK
5868,2016-03-05 00:00:00,BP,SAVE THE CHANGE,0.68,,14432.31,Savings,Swansea,UK
5869,2016-03-05 00:00:00,CPT,LNK SWANSEA WIND S,60.0,,14432.99,Cash,Swansea,UK
5870,29/04/2016,DEB,Amazon Svcs Europe,8.82,,14492.99,Amazon,Swansea,UK
5871,29/04/2016,DEB,Amazon UK Marketpl,8.5,,14501.81,Amazon,Swansea,UK
5872,29/04/2016,CPT,LOYD WALES UNIV SW,40.0,,14510.31,Cash,Swansea,UK
5873,29/04/2016,DD,UCU B ACCOUNT,22.37,,14550.31,Others,Swansea,UK
5874,29/04/2016,BGC,SWANSEA UNI - PAY,,3085.64,14572.68,Paycheck,Swansea,UK
5875,28/04/2016,BP,SAVE THE CHANGE,1.25,,11487.04,Savings,Swansea,UK
5876,27/04/2016,DEB,Amazon UK Marketpl,23.49,,11488.29,Amazon,Swansea,UK
5877,27/04/2016,CPT,LOYD WALES UNIV SW,50.0,,11511.78,Cash,Swansea,UK
5878,27/04/2016,DEB,Amazon UK Marketpl,9.26,,11561.78,Amazon,Swansea,UK
5879,26/04/2016,BP,SAVE THE CHANGE,1.46,,11571.04,Savings,Swansea,UK
5880,25/04/2016,DEB,Amazon UK Retail,34.99,,11572.5,Amazon,Swansea,UK
5881,25/04/2016,DEB,Amazon UK Marketpl,16.45,,11607.49,Amazon,Swansea,UK
5882,25/04/2016,DEB,Amazon UK Marketpl,13.99,,11623.94,Amazon,Swansea,UK
5883,25/04/2016,DEB,Amazon UK Marketpl,3.87,,11637.93,Amazon,Swansea,UK
5884,25/04/2016,DEB,Amazon UK Marketpl,12.86,,11641.8,Amazon,Swansea,UK
5885,25/04/2016,DEB,Amazon UK Marketpl,1.95,,11654.66,Amazon,Swansea,UK
5886,25/04/2016,DEB,Amazon UK Retail,26.43,,11656.61,Amazon,Swansea,UK
5887,25/04/2016,DD,CORGI HOMEPLAN CA,19.5,,11683.04,Home Improvement,Swansea,UK
5888,22/04/2016,CPT,LOYD WALES UNIV SW,40.0,,11702.54,Cash,Swansea,UK
5889,22/04/2016,DEP,SWANSEA UNIVERSITY,,491.23,11742.54,Supplementary Income,Swansea,UK
5890,22/04/2016,BP,SAVE THE CHANGE,0.07,,11251.31,Savings,Swansea,UK
5891,21/04/2016,DEB,HMSHOST AMSTERDAM,21.93,,11251.38,Dine Out,Amsterdam,Netherlands
5892,21/04/2016,DD,VIRGIN MEDIA PYMTS,27.99,,11273.31,Bills,Nottingham,UK
5893,21/04/2016,BP,SAVE THE CHANGE,0.01,,11301.3,Savings,Swansea,UK
5894,20/04/2016,DEB,Amazon UK Retail,11.99,,11301.31,Amazon,Swansea,UK
5895,19/04/2016,BP,SAVE THE CHANGE,0.99,,11313.3,Savings,Swansea,UK
5896,18/04/2016,DEB,HMSHOST AMSTERDAM,30.22,,11314.29,Dine Out,Amsterdam,Netherlands
5897,18/04/2016,DEB,NON-STG PURCH FEE,1.0,,11344.51,Others,Swansea,UK
5898,18/04/2016,DEB,NON-STG TRANS FEE,0.14,,11345.51,Others,Swansea,UK
5899,18/04/2016,DEB,WWW.HOTSPOTSCHIPHO,4.79,,11345.65,,,
5900,18/04/2016,DD,O2,38.92,,11350.44,Other Shopping,Swansea,UK
5901,18/04/2016,BP,SAVE THE CHANGE,1.42,,11389.36,Savings,Swansea,UK
5902,15/04/2016,DEB,Shop 1/ Fashion Sh,72.28,,11390.78,Clothes,,
5903,15/04/2016,DEB,ARRIVA TRAINS WALE,8.3,,11463.06,Travel,,
5904,15/04/2016,BP,SAVE THE CHANGE,0.1,,11471.36,Savings,Swansea,UK
5905,14/04/2016,DEB,JS ONLINE GROCERY,262.9,,11471.46,Groceries,Swansea,UK
5906,14/04/2016,CPT,LNK ARRIVA TRAINS,50.0,,11734.36,Cash,,
5907,14/04/2016,BP,SAVE THE CHANGE,0.5,,11784.36,Savings,Swansea,UK
5908,13/04/2016,DEB,W DAVIES & SON,12.5,,11784.86,Others,Swansea,UK
5909,13/04/2016,CPT,LOYD WALES UNIV SW,40.0,,11797.36,Cash,Swansea,UK
5910,2016-12-04 00:00:00,DEB,THE BIKE HUB,35.0,,11837.36,Other Shopping,,
5911,2016-12-04 00:00:00,CPT,LOYD WALES UNIV SW,50.0,,11872.36,Cash,Swansea,UK
5912,2016-12-04 00:00:00,BP,SAVE THE CHANGE,0.69,,11922.36,Savings,Swansea,UK
5913,2016-11-04 00:00:00,FPO,A.MEADOWCROFT,40.0,,11923.05,Services,Swansea,UK
5914,2016-11-04 00:00:00,DEB,Amazon UK Retail,7.8,,11963.05,Amazon,Swansea,UK
5915,2016-11-04 00:00:00,DEB,Amazon UK Marketpl,1.51,,11970.85,Amazon,Swansea,UK
5916,2016-11-04 00:00:00,BP,SAVE THE CHANGE,0.6,,11972.36,Savings,Swansea,UK
5917,2016-08-04 00:00:00,DEB,CHINA VISA SERVICE,176.0,,11972.96,Travel,,
5918,2016-08-04 00:00:00,DEB,ARRIVA TRAINS WALE,87.4,,12148.96,Travel,,
5919,2016-08-04 00:00:00,CPT,LOYD WALES UNIV SW,50.0,,12236.36,Cash,Swansea,UK
5920,2016-08-04 00:00:00,DD,LV LIFE,37.12,,12286.36,Insurance,Swansea,UK
5921,2016-08-04 00:00:00,BP,SAVE THE CHANGE,0.1,,12323.48,Savings,Swansea,UK
5922,2016-07-04 00:00:00,DEB,LUL TICKET MACHINE,4.9,,12323.58,Travel,London,UK
5923,2016-07-04 00:00:00,DEB,ST GILES HOTEL,239.0,,12328.48,Hotels,,
5924,2016-06-04 00:00:00,CPT,HFX  TOTTENHAM COU,50.0,,12567.48,Cash,London,UK
5925,2016-06-04 00:00:00,DD,CC SWANSEA C.TAX,125.44,,12617.48,Bills,Swansea,UK
5926,2016-06-04 00:00:00,BP,SAVE THE CHANGE,0.1,,12742.92,Savings,Swansea,UK
5927,2016-05-04 00:00:00,DEB,ARRIVA TRAINS WALE,101.0,,12743.02,Travel,,
5928,2016-05-04 00:00:00,DEB,LUL TICKET MACHINE,4.9,,12844.02,Travel,London,UK
5929,2016-05-04 00:00:00,DD,ASSURANT INTER LTD,35.56,,12848.92,Insurance,Swansea,UK
5930,2016-05-04 00:00:00,BP,SAVE THE CHANGE,2.33,,12884.48,Savings,Swansea,UK
5931,2016-04-04 00:00:00,DEB,Amazon UK Marketpl,74.99,,12886.81,Amazon,Swansea,UK
5932,2016-04-04 00:00:00,DEB,Amazon UK Marketpl,20.24,,12961.8,Amazon,Swansea,UK
5933,2016-04-04 00:00:00,DEB,Amazon *Mktplce EU,8.02,,12982.04,Amazon,Swansea,UK
5934,2016-04-04 00:00:00,DEB,Amazon UK Marketpl,5.42,,12990.06,Amazon,Swansea,UK
5935,2016-04-04 00:00:00,BP,SAVE THE CHANGE,0.15,,12995.48,Savings,Swansea,UK
5936,2016-01-04 00:00:00,FEE,ACCOUNT FEE,9.95,,12995.63,Bills,Swansea,UK
5937,2016-01-04 00:00:00,,INTEREST (NET),,5.07,13005.58,Interest,Swansea,UK
5938,2016-01-04 00:00:00,DEB,Amazon UK Marketpl,3.85,,13000.51,Amazon,Swansea,UK
5939,2016-01-04 00:00:00,DD,NATWEST BANK,828.49,,13004.36,Mortgage,Swansea,UK
5940,2016-01-04 00:00:00,DD,GOOD ENERGY GAS,43.0,,13832.85,Bills,Swansea,UK
5941,2016-01-04 00:00:00,DD,DWR CYMRU W WATER,14.5,,13875.85,Bills,Swansea,UK
5942,2016-01-04 00:00:00,DD,GOOD ENERGY LTD,13.0,,13890.35,Bills,Swansea,UK
5943,2016-01-04 00:00:00,DD,TV LICENCE MBP,12.12,,13903.35,Bills,Swansea,UK
5944,2016-01-04 00:00:00,SO,ESAVINGS ACCOUNT,300.0,,13915.47,Savings,Swansea,UK
5945,2016-01-04 00:00:00,BP,SAVE THE CHANGE,1.31,,14215.47,Savings,Swansea,UK
5946,31/03/2016,DEB,Amazon UK Retail,12.45,,14216.78,Amazon,Swansea,UK
5947,31/03/2016,DEB,Amazon UK Marketpl,10.24,,14229.23,Amazon,Swansea,UK
5948,31/03/2016,DD,UNIV & COL UNION,22.37,,14239.47,Services,Swansea,UK
5949,31/03/2016,BGC,SWANSEA UNIVERSITY,,3126.88,14261.84,Supplementary Income,Swansea,UK
5950,30/03/2016,BP,SAVE THE CHANGE,2.14,,11134.96,Savings,Swansea,UK
5951,29/03/2016,DEB,Amazon UK Marketpl,27.89,,11137.1,Amazon,Swansea,UK
5952,29/03/2016,DEB,Amazon UK Marketpl,17.95,,11164.99,Amazon,Swansea,UK
5953,29/03/2016,DEB,Amazon UK Marketpl,16.17,,11182.94,Amazon,Swansea,UK
5954,29/03/2016,DEB,POST OFFICE COUNTE,14.5,,11199.11,Others,Swansea,UK
5955,29/03/2016,DEB,Amazon UK Marketpl,6.56,,11213.61,Amazon,Swansea,UK
5956,29/03/2016,DEB,Amazon UK Marketpl,5.79,,11220.17,Amazon,Swansea,UK
5957,29/03/2016,CPT,LOYD WALES UNIV SW,30.0,,11225.96,Cash,Swansea,UK
5958,24/03/2016,CPT,LOYD WALES UNIV SW,50.0,,11255.96,Cash,Swansea,UK
5959,24/03/2016,BP,SAVE THE CHANGE,0.2,,11305.96,Savings,Swansea,UK
5960,23/03/2016,DEB,ARRIVA TRAINS WALE,91.8,,11306.16,Travel,,
5961,22/03/2016,DEB,Amazon UK Marketpl,18.0,,11397.96,Amazon,Swansea,UK
5962,22/03/2016,DD,CORGI HOMEPLAN CA,19.5,,11415.96,Home Improvement,Swansea,UK
5963,22/03/2016,BP,SAVE THE CHANGE,0.52,,11435.46,Savings,Swansea,UK
5964,21/03/2016,DEB,Amazon UK Retail,7.5,,11435.98,Amazon,Swansea,UK
5965,21/03/2016,DEB,Amazon UK Marketpl,4.98,,11443.48,Amazon,Swansea,UK
5966,21/03/2016,DD,VIRGIN MEDIA PYMTS,27.99,,11448.46,Bills,Nottingham,UK
5967,21/03/2016,BP,SAVE THE CHANGE,0.14,,11476.45,Savings,Swansea,UK
5968,18/03/2016,DEB,Amazon UK Marketpl,19.99,,11476.59,Amazon,Swansea,UK
5969,18/03/2016,DEB,Amazon UK Marketpl,2.87,,11496.58,Amazon,Swansea,UK
5970,18/03/2016,CPT,LOYD WALES UNIV SW,50.0,,11499.45,Cash,Swansea,UK
5971,18/03/2016,BP,SAVE THE CHANGE,2.0,,11549.45,Savings,Swansea,UK
5972,17/03/2016,DEB,Amazon Svcs Europe,17.24,,11551.45,Amazon,Swansea,UK
5973,17/03/2016,DEB,POST OFFICE COUNTE,14.5,,11568.69,Others,Swansea,UK
5974,17/03/2016,DEB,Amazon UK Marketpl,4.26,,11583.19,Amazon,Swansea,UK
5975,17/03/2016,BP,SAVE THE CHANGE,2.68,,11587.45,Savings,Swansea,UK
5976,16/03/2016,DEB,WWW.COLSTONHALL.OR,85.35,,11590.13,Travel,Bristol,
5977,16/03/2016,DEB,Amazon UK Retail,12.35,,11675.48,Amazon,Swansea,UK
5978,16/03/2016,DEB,Amazon UK Retail,11.99,,11687.83,Amazon,Swansea,UK
5979,16/03/2016,DEB,Amazon UK Marketpl,11.41,,11699.82,Amazon,Swansea,UK
5980,16/03/2016,DEB,Amazon Svcs Europe,10.22,,11711.23,Amazon,Swansea,UK
5981,16/03/2016,CPT,LOYD WALES UNIV SW,50.0,,11721.45,Cash,Swansea,UK
5982,16/03/2016,DD,O2,18.21,,11771.45,Other Shopping,Swansea,UK
5983,15/03/2016,BP,SAVE THE CHANGE,0.91,,11789.66,Savings,Swansea,UK
5984,14/03/2016,DEB,AMAZON MKTPLACE PM,26.85,,11790.57,Amazon,Swansea,UK
5985,14/03/2016,DEB,Amazon Svcs Europe,2.75,,11817.42,Amazon,Swansea,UK
5986,14/03/2016,DEB,NON-STG PURCH FEE,1.0,,11820.17,Others,Swansea,UK
5987,14/03/2016,DEB,NON-STG TRANS FEE,0.1,,11821.17,Others,Swansea,UK
5988,14/03/2016,DEB,RLR-CC.COM 1 88846,3.49,,11821.27,Others,Swansea,UK
5989,14/03/2016,BP,SAVE THE CHANGE,0.72,,11824.76,Savings,Swansea,UK
5990,14/03/2016,BGC,UNIOF WARWICK,,101.45,11825.48,Supplementary Income,Swansea,UK
5991,14/03/2016,DEB,NON-STG PURCH FEE,1.0,,11724.03,Others,Swansea,UK
5992,14/03/2016,DEB,NON-STG TRANS FEE,0.1,,11725.03,Others,Swansea,UK
5993,14/03/2016,DEB,ACTBLUE*BERNIE.SAN,3.54,,11725.13,Services,Swansea,UK
5994,2016-11-03 00:00:00,DEB,Amazon UK Marketpl,10.74,,11728.67,Amazon,Swansea,UK
5995,2016-10-03 00:00:00,CHQ,45,1100.0,,11739.41,Cash,,
5996,2016-09-03 00:00:00,DEB,Amazon Prime,79.0,,12839.41,Amazon,Swansea,UK
5997,2016-09-03 00:00:00,DD,LV LIFE,37.12,,12918.41,Insurance,Swansea,UK
5998,2016-09-03 00:00:00,BP,SAVE THE CHANGE,0.58,,12955.53,Savings,Swansea,UK
5999,2016-08-03 00:00:00,DEB,AMAZON MKTPLACE PM,12.42,,12956.11,Amazon,Swansea,UK
6000,2016-07-03 00:00:00,BP,SAVE THE CHANGE,0.43,,12968.53,Savings,Swansea,UK
6001,2016-04-03 00:00:00,DEB,NON-STG PURCH FEE,1.0,,12968.96,Others,Swansea,UK
6002,2016-04-03 00:00:00,DEB,NON-STG TRANS FEE,0.1,,12969.96,Others,Swansea,UK
6003,2016-04-03 00:00:00,DEB,ACTBLUE*BERNIE.SAN,3.57,,12970.06,Services,Swansea,UK
6004,2016-04-03 00:00:00,CPT,LOYD WALES UNIV SW,50.0,,12973.63,Cash,Swansea,UK
6005,2016-04-03 00:00:00,BP,SAVE THE CHANGE,0.55,,13023.63,Savings,Swansea,UK
6006,2016-03-03 00:00:00,DEB,JS ONLINE GROCERY,241.45,,13024.18,Groceries,Swansea,UK
6007,2016-03-03 00:00:00,DD,ASSURANT INTER LTD,35.56,,13265.63,Insurance,Swansea,UK
6008,2016-03-03 00:00:00,BP,SAVE THE CHANGE,0.51,,13301.19,Savings,Swansea,UK
6009,2016-02-03 00:00:00,DEB,Amazon UK Retail,10.49,,13301.7,Amazon,Swansea,UK
6010,2016-02-03 00:00:00,TFR,F/FLOW UNIVERSITY,,907.92,13312.19,Supplementary Income,Swansea,UK
6011,2016-02-03 00:00:00,BP,SAVE THE CHANGE,0.05,,12404.27,Savings,Swansea,UK
6012,2016-01-03 00:00:00,FEE,ACCOUNT FEE,9.95,,12404.32,Bills,Swansea,UK
6013,2016-01-03 00:00:00,,INTEREST (NET),,4.74,12414.27,Interest,Swansea,UK
6014,2016-01-03 00:00:00,DEB,Amazon UK Marketpl,49.95,,12409.53,Amazon,Swansea,UK
6015,2016-01-03 00:00:00,DD,NATWEST BANK,828.49,,12459.48,Mortgage,Swansea,UK
6016,2016-01-03 00:00:00,DD,GOOD ENERGY GAS,43.0,,13287.97,Bills,Swansea,UK
6017,2016-01-03 00:00:00,DD,DWR CYMRU W WATER,14.5,,13330.97,Bills,Swansea,UK
6018,2016-01-03 00:00:00,DD,GOOD ENERGY LTD,13.0,,13345.47,Bills,Swansea,UK
6019,2016-01-03 00:00:00,DD,TV LICENCE MBP,12.12,,13358.47,Bills,Swansea,UK
6020,2016-01-03 00:00:00,SO,ESAVINGS ACCOUNT,300.0,,13370.59,Savings,Swansea,UK
6021,29/02/2016,DEB,IKEA ONLINE,98.0,,13670.59,Other Shopping,,
6022,29/02/2016,DD,UNIV & COL UNION,22.37,,13768.59,Services,Swansea,UK
6023,29/02/2016,BGC,SWANSEA UNIVERSITY,,3127.28,13790.96,Supplementary Income,Swansea,UK
6024,26/02/2016,CPT,LOYD WALES UNIV SW,50.0,,10663.68,Cash,Swansea,UK
6025,26/02/2016,BGC,SWANSEA UNIVERSITY,,964.6,10713.68,Supplementary Income,Swansea,UK
6026,25/02/2016,CHQ,44,50.0,,9749.08,Cash,,
6027,24/02/2016,BP,SAVE THE CHANGE,0.01,,9799.08,Savings,Swansea,UK
6028,23/02/2016,DEB,Amazon UK Retail,11.99,,9799.09,Amazon,Swansea,UK
6029,23/02/2016,CPT,LOYD WALES UNIV SW,40.0,,9811.08,Cash,Swansea,UK
6030,23/02/2016,FPO,A.MEADOWCROFT,65.0,,9851.08,Services,Swansea,UK
6031,23/02/2016,BP,SAVE THE CHANGE,0.56,,9916.08,Savings,Swansea,UK
6032,22/02/2016,DEB,Amazon UK Marketpl,37.69,,9916.64,Amazon,Swansea,UK
6033,22/02/2016,DEB,Amazon UK Retail,10.0,,9954.33,Amazon,Swansea,UK
6034,22/02/2016,DEB,Amazon UK Marketpl,4.75,,9964.33,Amazon,Swansea,UK
6035,22/02/2016,DD,VIRGIN MEDIA PYMTS,27.99,,9969.08,Bills,Nottingham,UK
6036,19/02/2016,CPT,LOYD WALES UNIV SW,30.0,,9997.07,Cash,Swansea,UK
6037,19/02/2016,BP,SAVE THE CHANGE,0.67,,10027.07,Savings,Swansea,UK
6038,18/02/2016,DEB,Amazon UK Marketpl,12.99,,10027.74,Amazon,Swansea,UK
6039,18/02/2016,DEB,Amazon UK Marketpl,1.34,,10040.73,Amazon,Swansea,UK
6040,18/02/2016,BP,SAVE THE CHANGE,1.35,,10042.07,Savings,Swansea,UK
6041,17/02/2016,DEB,ARRIVA TRAINS WALE,73.5,,10043.42,Travel,,
6042,17/02/2016,DEB,Amazon UK Marketpl,21.16,,10116.92,Amazon,Swansea,UK
6043,17/02/2016,DEB,Amazon UK Marketpl,19.99,,10138.08,Amazon,Swansea,UK
6044,16/02/2016,CPT,LNK ARRIVA TRAINS,50.0,,10158.07,Cash,,
6045,16/02/2016,DD,O2,18.92,,10208.07,Other Shopping,Swansea,UK
6046,16/02/2016,BP,SAVE THE CHANGE,0.92,,10226.99,Savings,Swansea,UK
6047,15/02/2016,DEB,Amazon UK Retail,21.09,,10227.91,Amazon,Swansea,UK
6048,15/02/2016,DEB,Amazon UK Retail,7.0,,10249.0,Amazon,Swansea,UK
6049,15/02/2016,DEB,Amazon UK Marketpl,3.99,,10256.0,Amazon,Swansea,UK
6050,15/02/2016,DEP,SWANSEA UNIVERSITY,,18.0,10259.99,Supplementary Income,Swansea,UK
6051,2016-12-02 00:00:00,CPT,LOYD WALES UNIV SW,20.0,,10241.99,Cash,Swansea,UK
6052,2016-11-02 00:00:00,CPT,LOYD WALES UNIV SW,40.0,,10261.99,Cash,Swansea,UK
6053,2016-10-02 00:00:00,BP,SAVE THE CHANGE,0.01,,10301.99,Savings,Swansea,UK
6054,2016-09-02 00:00:00,DEB,Amazon UK Retail,17.99,,10302.0,Amazon,Swansea,UK
6055,2016-09-02 00:00:00,DEB,Amazon UK Retail,5.0,,10319.99,Amazon,Swansea,UK
6056,2016-08-02 00:00:00,DD,LV LIFE,37.12,,10324.99,Insurance,Swansea,UK
6057,2016-08-02 00:00:00,FPO,A.MEADOWCROFT,90.0,,10362.11,Services,Swansea,UK
6058,2016-05-02 00:00:00,CPT,LOYD WALES UNIV SW,100.0,,10452.11,Cash,Swansea,UK
6059,2016-04-02 00:00:00,CPT,LOYD WALES UNIV SW,100.0,,10552.11,Cash,Swansea,UK
6060,2016-04-02 00:00:00,BP,SAVE THE CHANGE,0.25,,10652.11,Savings,Swansea,UK
6061,2016-03-02 00:00:00,DEB,Amazon UK Marketpl,8.75,,10652.36,Amazon,Swansea,UK
6062,2016-03-02 00:00:00,DD,ASSURANT INTER LTD,35.56,,10661.11,Insurance,Swansea,UK
6063,2016-02-02 00:00:00,CPT,LOYD WALES UNIV SW,50.0,,10696.67,Cash,Swansea,UK
6064,2016-02-02 00:00:00,BP,SAVE THE CHANGE,1.33,,10746.67,Savings,Swansea,UK
6065,2016-01-02 00:00:00,FEE,ACCOUNT FEE,9.95,,10748.0,Bills,Swansea,UK
6066,2016-01-02 00:00:00,,INTEREST (NET),,4.57,10757.95,Interest,Swansea,UK
6067,2016-01-02 00:00:00,DEB,Amazon UK Marketpl,26.55,,10753.38,Amazon,Swansea,UK
6068,2016-01-02 00:00:00,DEB,Amazon UK Marketpl,19.28,,10779.93,Amazon,Swansea,UK
6069,2016-01-02 00:00:00,DEB,Amazon UK Marketpl,9.84,,10799.21,Amazon,Swansea,UK
6070,2016-01-02 00:00:00,DD,NATWEST BANK,828.49,,10809.05,Mortgage,Swansea,UK
6071,2016-01-02 00:00:00,DD,CC SWANSEA C.TAX,122.0,,11637.54,Bills,Swansea,UK
6072,2016-01-02 00:00:00,DD,GOOD ENERGY GAS,43.0,,11759.54,Bills,Swansea,UK
6073,2016-01-02 00:00:00,DD,DWR CYMRU W WATER,14.5,,11802.54,Bills,Swansea,UK
6074,2016-01-02 00:00:00,DD,GOOD ENERGY LTD,13.0,,11817.04,Bills,Swansea,UK
6075,2016-01-02 00:00:00,DD,TV LICENCE MBP,12.12,,11830.04,Bills,Swansea,UK
6076,2016-01-02 00:00:00,SO,ESAVINGS ACCOUNT,300.0,,11842.16,Savings,Swansea,UK
6077,2016-01-02 00:00:00,BP,SAVE THE CHANGE,0.85,,12142.16,Savings,Swansea,UK
6078,29/01/2016,DEB,Amazon UK Marketpl,1.15,,12143.01,Amazon,Swansea,UK
6079,29/01/2016,CPT,LOYD WALES UNIV SW,50.0,,12144.16,Cash,Swansea,UK
6080,29/01/2016,DD,UNIV & COL UNION,22.37,,12194.16,Services,Swansea,UK
6081,29/01/2016,BGC,SWANSEA UNIVERSITY,,3126.88,12216.53,Supplementary Income,Swansea,UK
6082,27/01/2016,BP,SAVE THE CHANGE,1.32,,9089.65,Savings,Swansea,UK
6083,26/01/2016,DEB,Amazon UK Retail,17.17,,9090.97,Amazon,Swansea,UK
6084,26/01/2016,DEB,Amazon UK Marketpl,9.99,,9108.14,Amazon,Swansea,UK
6085,26/01/2016,DEB,Amazon UK Marketpl,7.98,,9118.13,Amazon,Swansea,UK
6086,26/01/2016,DEB,Amazon UK Marketpl,5.9,,9126.11,Amazon,Swansea,UK
6087,26/01/2016,DEB,Amazon UK Marketpl,3.64,,9132.01,Amazon,Swansea,UK
6088,26/01/2016,CPT,LOYD WALES UNIV SW,50.0,,9135.65,Cash,Swansea,UK
6089,25/01/2016,BP,SAVE THE CHANGE,0.39,,9185.65,Savings,Swansea,UK
6090,22/01/2016,DEB,NON-STG PURCH FEE,1.0,,9186.04,Others,Swansea,UK
6091,22/01/2016,DEB,NON-STG TRANS FEE,20.41,,9187.04,Others,Swansea,UK
6092,22/01/2016,DEB,HILTON HTL UNIV OF,682.61,,9207.45,Travel,,
6093,21/01/2016,DD,VIRGIN MEDIA PYMTS,16.91,,9890.06,Bills,Nottingham,UK
6094,21/01/2016,DEB,NON-STG CASH FEE,2.0,,9906.97,Others,Swansea,UK
6095,21/01/2016,DEB,NON-STG TRANS FEE,2.16,,9908.97,Others,Swansea,UK
6096,21/01/2016,DEB,*UNIVERSITY OF HOU,72.51,,9911.13,Travel,Houston,USA
6097,20/01/2016,BP,SAVE THE CHANGE,0.55,,9983.64,Savings,Swansea,UK
6098,19/01/2016,DEB,NON-STG PURCH FEE,1.0,,9984.19,Others,Swansea,UK
6099,19/01/2016,DEB,NON-STG TRANS FEE,0.52,,9985.19,Others,Swansea,UK
6100,19/01/2016,DEB,UNITED  016260,17.45,,9985.71,Travel,,
6101,19/01/2016,BP,SAVE THE CHANGE,0.8,,10003.16,Savings,Swansea,UK
6102,18/01/2016,DEB,NON-STG PURCH FEE,1.0,,10003.96,Others,Swansea,UK
6103,18/01/2016,DEB,NON-STG TRANS FEE,4.55,,10004.96,Others,Swansea,UK
6104,18/01/2016,DEB,HOLIDAY INN HOUSTO,152.2,,10009.51,Hotels,,
6105,18/01/2016,DD,O2,16.62,,10161.71,Other Shopping,Swansea,UK
6106,2016-12-01 00:00:00,BP,SAVE THE CHANGE,1.94,,10178.33,Savings,Swansea,UK
6107,2016-11-01 00:00:00,DEB,NON-STG PURCH FEE,1.0,,10180.27,Others,Swansea,UK
6108,2016-11-01 00:00:00,DEB,NON-STG TRANS FEE,0.55,,10181.27,Others,Swansea,UK
6109,2016-11-01 00:00:00,DEB,HOUSTON GEORGE BUS,18.59,,10181.82,Travel,Huston,USA
6110,2016-11-01 00:00:00,DEB,NON-STG PURCH FEE,1.0,,10200.41,Others,Swansea,UK
6111,2016-11-01 00:00:00,DEB,NON-STG TRANS FEE,0.51,,10201.41,Others,Swansea,UK
6112,2016-11-01 00:00:00,DEB,UNITED  016260,17.18,,10201.92,Travel,,
6113,2016-11-01 00:00:00,DEB,Amazon UK Marketpl,14.29,,10219.1,Amazon,Swansea,UK
6114,2016-11-01 00:00:00,BP,SAVE THE CHANGE,0.16,,10233.39,Savings,Swansea,UK
6115,2016-08-01 00:00:00,DEB,Amazon UK Retail,34.99,,10233.55,Amazon,Swansea,UK
6116,2016-08-01 00:00:00,DEB,Amazon UK Marketpl,7.85,,10268.54,Amazon,Swansea,UK
6117,2016-08-01 00:00:00,CPT,LOYD WALES UNIV SW,40.0,,10276.39,Cash,Swansea,UK
6118,2016-08-01 00:00:00,DD,LV LIFE,37.12,,10316.39,Insurance,Swansea,UK
6119,2016-08-01 00:00:00,BP,SAVE THE CHANGE,1.2,,10353.51,Savings,Swansea,UK
6120,2016-07-01 00:00:00,DEB,JS ONLINE GROCERY,231.6,,10354.71,Groceries,Swansea,UK
6121,2016-07-01 00:00:00,DEB,AMAZON MKTPLACE PM,16.2,,10586.31,Amazon,Swansea,UK
6122,2016-07-01 00:00:00,CPT,LOYD WALES UNIV SW,100.0,,10602.51,Cash,Swansea,UK
6123,2016-07-01 00:00:00,BP,SAVE THE CHANGE,0.77,,10702.51,Savings,Swansea,UK
6124,2016-06-01 00:00:00,DEB,Amazon UK Marketpl,11.75,,10703.28,Amazon,Swansea,UK
6125,2016-06-01 00:00:00,DEB,Amazon UK Marketpl,5.5,,10715.03,Amazon,Swansea,UK
6126,2016-06-01 00:00:00,DEB,Amazon UK Marketpl,3.98,,10720.53,Amazon,Swansea,UK
6127,2016-05-01 00:00:00,CPT,LOYD WALES UNIV SW,100.0,,10724.51,Cash,Swansea,UK
6128,2016-05-01 00:00:00,BP,SAVE THE CHANGE,0.15,,10824.51,Savings,Swansea,UK
6129,2016-04-01 00:00:00,FEE,ACCOUNT FEE,9.95,,10824.66,Bills,Swansea,UK
6130,2016-04-01 00:00:00,,INTEREST (NET),,5.56,10834.61,Interest,Swansea,UK
6131,2016-04-01 00:00:00,DEB,Amazon UK Retail,8.99,,10829.05,Amazon,Swansea,UK
6132,2016-04-01 00:00:00,DEB,Amazon UK Marketpl,1.86,,10838.04,Amazon,Swansea,UK
6133,2016-04-01 00:00:00,DD,NATWEST BANK,828.49,,10839.9,Mortgage,Swansea,UK
6134,2016-04-01 00:00:00,DD,CC SWANSEA C.TAX,122.0,,11668.39,Bills,Swansea,UK
6135,2016-04-01 00:00:00,DD,GOOD ENERGY GAS,43.0,,11790.39,Bills,Swansea,UK
6136,2016-04-01 00:00:00,DD,ASSURANT INTER LTD,35.56,,11833.39,Insurance,Swansea,UK
6137,2016-04-01 00:00:00,DD,DWR CYMRU W WATER,14.5,,11868.95,Bills,Swansea,UK
6138,2016-04-01 00:00:00,DD,GOOD ENERGY LTD,13.0,,11883.45,Bills,Swansea,UK
6139,2016-04-01 00:00:00,DD,TV LICENCE MBP,12.12,,11896.45,Bills,Swansea,UK
6140,2016-04-01 00:00:00,SO,ESAVINGS ACCOUNT,300.0,,11908.57,Savings,Swansea,UK
6141,2016-04-01 00:00:00,BP,SAVE THE CHANGE,1.97,,12208.57,Savings,Swansea,UK
6142,2016-04-01 00:00:00,CPT,LNK THE COOPERATIV,40.0,,12210.54,Cash,,
6143,31/12/2015,DEB,Amazon UK Retail,26.93,,12250.54,Amazon,Swansea,UK
6144,31/12/2015,DEB,Amazon UK Retail,8.97,,12277.47,Amazon,Swansea,UK
6145,31/12/2015,DEB,Amazon UK Marketpl,8.36,,12286.44,Amazon,Swansea,UK
6146,31/12/2015,DEB,Amazon UK Marketpl,2.55,,12294.8,Amazon,Swansea,UK
6147,31/12/2015,DEB,PAYPAL *CARL DAVIE,47.22,,12297.35,Services,Swansea,UK
6148,31/12/2015,DD,UNIV & COL UNION,22.37,,12344.57,Services,Swansea,UK
6149,31/12/2015,BP,SAVE THE CHANGE,3.39,,12366.94,Savings,Swansea,UK
6150,30/12/2015,DEB,LUSH RETAIL LTD,47.29,,12370.33,Other Shopping,,
6151,30/12/2015,DEB,SPORTSDIRECT 141,19.99,,12417.62,Other Shopping,,
6152,30/12/2015,DEB,EXOTICA,13.14,,12437.61,Groceries,Swansea,UK
6153,30/12/2015,DEB,Amazon UK Marketpl,6.2,,12450.75,Amazon,Swansea,UK
6154,30/12/2015,DEB,Amazon UK Marketpl,4.98,,12456.95,Amazon,Swansea,UK
6155,30/12/2015,DEB,Amazon Svcs Europe,3.94,,12461.93,Amazon,Swansea,UK
6156,30/12/2015,DEB,Amazon Svcs Europe,2.07,,12465.87,Amazon,Swansea,UK
6157,30/12/2015,BP,SAVE THE CHANGE,0.21,,12467.94,Savings,Swansea,UK
6158,29/12/2015,DEB,Amazon UK Marketpl,117.99,,12468.15,Amazon,Swansea,UK
6159,29/12/2015,DEB,SAINSBURYS - SWANS,22.85,,12586.14,Groceries,Swansea,UK
6160,29/12/2015,DEB,Amazon UK Marketpl,32.95,,12608.99,Amazon,Swansea,UK
6161,29/12/2015,DEB,CO-OP GROUP FOOD,19.0,,12641.94,Groceries,,
6162,29/12/2015,DEB,Amazon UK Retail,12.0,,12660.94,Amazon,Swansea,UK
6163,24/12/2015,BP,SAVE THE CHANGE,0.13,,12672.94,Savings,Swansea,UK
6164,24/12/2015,BGC,SWANSEA UNIVERSITY,,1612.63,12673.07,Supplementary Income,Swansea,UK
6165,23/12/2015,DEB,Amazon UK Marketpl,1.87,,11060.44,Amazon,Swansea,UK
6166,23/12/2015,BP,SAVE THE CHANGE,0.8,,11062.31,Savings,Swansea,UK
6167,22/12/2015,DEB,Amazon UK Marketpl,9.2,,11063.11,Amazon,Swansea,UK
6168,22/12/2015,CPT,LOYD WALES UNIV SW,50.0,,11072.31,Cash,Swansea,UK
6169,22/12/2015,BP,SAVE THE CHANGE,1.54,,11122.31,Savings,Swansea,UK
6170,21/12/2015,DEB,ODEON/BOOKIT,26.0,,11123.85,Entertainment,,
6171,21/12/2015,DEB,Amazon UK Marketpl,17.99,,11149.85,Amazon,Swansea,UK
6172,21/12/2015,DEB,UNITED AIR  016936,117.7,,11167.84,Travel,,
6173,21/12/2015,DEB,Amazon UK Marketpl,29.68,,11285.54,Amazon,Swansea,UK
6174,21/12/2015,DEB,GODADDY COM EUROPE,12.2,,11315.22,Others,Swansea,UK
6175,21/12/2015,DEB,EXPEDIA 1104152727,10.0,,11327.42,Travel,,
6176,21/12/2015,DEB,Amazon UK Marketpl,6.97,,11337.42,Amazon,Swansea,UK
6177,21/12/2015,DEB,Amazon UK Marketpl,1.92,,11344.39,Amazon,Swansea,UK
6178,21/12/2015,DD,VIRGIN MEDIA PYMTS,37.78,,11346.31,Bills,Nottingham,UK
6179,21/12/2015,BP,SAVE THE CHANGE,1.65,,11384.09,Savings,Swansea,UK
6180,21/12/2015,BGC,SWANSEA UNIVERSITY,,3127.28,11385.74,Supplementary Income,Swansea,UK
6181,18/12/2015,DEB,Amazon UK Marketpl,4.28,,8258.46,Amazon,Swansea,UK
6182,18/12/2015,DEB,Amazon UK Marketpl,1.07,,8262.74,Amazon,Swansea,UK
6183,17/12/2015,BP,SAVE THE CHANGE,0.01,,8263.81,Savings,Swansea,UK
6184,16/12/2015,DEB,Amazon UK Marketpl,9.99,,8263.82,Amazon,Swansea,UK
6185,16/12/2015,CPT,LOYD WALES UNIV SW,40.0,,8273.81,Cash,Swansea,UK
6186,16/12/2015,DD,O2,17.42,,8313.81,Other Shopping,Swansea,UK
6187,16/12/2015,BP,SAVE THE CHANGE,0.11,,8331.23,Savings,Swansea,UK
6188,15/12/2015,DEB,PUB ON THE POND,28.99,,8331.34,Dine Out,Swansea,UK
6189,15/12/2015,DEB,Amazon UK Marketpl,13.9,,8360.33,Amazon,Swansea,UK
6190,15/12/2015,CPT,LOYD WALES UNIV SW,50.0,,8374.23,Cash,Swansea,UK
6191,15/12/2015,BP,SAVE THE CHANGE,0.15,,8424.23,Savings,Swansea,UK
6192,14/12/2015,DEB,Amazon UK Retail,21.99,,8424.38,Amazon,Swansea,UK
6193,14/12/2015,DEB,Amazon Svcs Europe,5.98,,8446.37,Amazon,Swansea,UK
6194,14/12/2015,DEB,Amazon UK Marketpl,7.88,,8452.35,Amazon,Swansea,UK
6195,14/12/2015,DEB,WIKIMEDIA,2.0,,8460.23,Others,Swansea,UK
6196,14/12/2015,BP,SAVE THE CHANGE,0.64,,8462.23,Savings,Swansea,UK
6197,2015-11-12 00:00:00,DEB,Amazon UK Retail,119.99,,8462.87,Amazon,Swansea,UK
6198,2015-11-12 00:00:00,DEB,SUSU TRADING LTD,44.53,,8582.86,Home Improvement,Swansea,UK
6199,2015-11-12 00:00:00,DEB,Amazon UK Marketpl,14.85,,8627.39,Amazon,Swansea,UK
6200,2015-11-12 00:00:00,DEB,Amazon UK Retail,3.99,,8642.24,Amazon,Swansea,UK
6201,2015-10-12 00:00:00,CHQ,43,200.0,,8646.23,Cash,,
6202,2015-10-12 00:00:00,BP,SAVE THE CHANGE,1.29,,8846.23,Savings,Swansea,UK
6203,2015-09-12 00:00:00,DEB,AMAZON MKTPLACE PM,10.74,,8847.52,Amazon,Swansea,UK
6204,2015-09-12 00:00:00,DEB,Amazon UK Marketpl,4.7,,8858.26,Amazon,Swansea,UK
6205,2015-09-12 00:00:00,DEB,Amazon UK Marketpl,2.27,,8862.96,Amazon,Swansea,UK
6206,2015-09-12 00:00:00,DEB,SKYPE SUBSCRIPTION,10.0,,8865.23,Bills,Swansea,UK
6207,2015-09-12 00:00:00,DD,LV LIFE,37.12,,8875.23,Insurance,Swansea,UK
6208,2015-08-12 00:00:00,BP,SAVE THE CHANGE,2.17,,8912.35,Savings,Swansea,UK
6209,2015-07-12 00:00:00,DEB,Amazon UK Marketpl,23.99,,8914.52,Amazon,Swansea,UK
6210,2015-07-12 00:00:00,DEB,Amazon UK Retail,13.36,,8938.51,Amazon,Swansea,UK
6211,2015-07-12 00:00:00,DEB,Amazon UK Retail,11.99,,8951.87,Amazon,Swansea,UK
6212,2015-07-12 00:00:00,DEB,Amazon UK Retail,3.87,,8963.86,Amazon,Swansea,UK
6213,2015-07-12 00:00:00,DEB,NON-STG PURCH FEE,1.0,,8967.73,Others,Swansea,UK
6214,2015-07-12 00:00:00,DEB,NON-STG TRANS FEE,6.23,,8968.73,Others,Swansea,UK
6215,2015-07-12 00:00:00,DEB,ACTIVATORME,208.38,,8974.96,Other Shopping,Swansea,UK
6216,2015-07-12 00:00:00,DEB,Amazon UK Marketpl,9.24,,9183.34,Amazon,Swansea,UK
6217,2015-07-12 00:00:00,BP,SAVE THE CHANGE,1.23,,9192.58,Savings,Swansea,UK
6218,2015-04-12 00:00:00,DEB,Amazon UK Marketpl,7.74,,9193.81,Amazon,Swansea,UK
6219,2015-04-12 00:00:00,DEB,Amazon UK Marketpl,2.03,,9201.55,Amazon,Swansea,UK
6220,2015-04-12 00:00:00,BP,SAVE THE CHANGE,0.8,,9203.58,Savings,Swansea,UK
6221,2015-03-12 00:00:00,DEB,JS ONLINE GROCERY,266.6,,9204.38,Groceries,Swansea,UK
6222,2015-03-12 00:00:00,DEB,Amazon UK Marketpl,4.6,,9470.98,Amazon,Swansea,UK
6223,2015-03-12 00:00:00,DD,ASSURANT INTER LTD,35.56,,9475.58,Insurance,Swansea,UK
6224,2015-03-12 00:00:00,BP,SAVE THE CHANGE,0.17,,9511.14,Savings,Swansea,UK
6225,2015-02-12 00:00:00,DEB,Amazon UK Marketpl,10.83,,9511.31,Amazon,Swansea,UK
6226,2015-02-12 00:00:00,BP,SAVE THE CHANGE,1.15,,9522.14,Savings,Swansea,UK
6227,2015-01-12 00:00:00,FEE,ACCOUNT FEE,9.95,,9523.29,Bills,Swansea,UK
6228,2015-01-12 00:00:00,,INTEREST (NET),,4.74,9533.24,Interest,Swansea,UK
6229,2015-01-12 00:00:00,DEB,Amazon Svcs Europe,6.6,,9528.5,Amazon,Swansea,UK
6230,2015-01-12 00:00:00,DEB,Amazon UK Marketpl,2.25,,9535.1,Amazon,Swansea,UK
6231,2015-01-12 00:00:00,DD,NATWEST BANK,828.49,,9537.35,Mortgage,Swansea,UK
6232,2015-01-12 00:00:00,DD,CC SWANSEA C.TAX,122.0,,10365.84,Bills,Swansea,UK
6233,2015-01-12 00:00:00,DD,GOOD ENERGY GAS,43.0,,10487.84,Bills,Swansea,UK
6234,2015-01-12 00:00:00,DD,DWR CYMRU W WATER,14.5,,10530.84,Bills,Swansea,UK
6235,2015-01-12 00:00:00,DD,GOOD ENERGY LTD,13.0,,10545.34,Bills,Swansea,UK
6236,2015-01-12 00:00:00,DD,TV LICENCE MBP,12.18,,10558.34,Bills,Swansea,UK
6237,2015-01-12 00:00:00,SO,ESAVINGS ACCOUNT,300.0,,10570.52,Savings,Swansea,UK
6238,2015-01-12 00:00:00,BP,SAVE THE CHANGE,1.34,,10870.52,Savings,Swansea,UK
6239,30/11/2015,DEB,Amazon UK Marketpl,11.99,,10871.86,Amazon,Swansea,UK
6240,30/11/2015,DEB,Amazon UK Marketpl,6.95,,10883.85,Amazon,Swansea,UK
6241,30/11/2015,DEB,Amazon UK Retail,5.49,,10890.8,Amazon,Swansea,UK
6242,30/11/2015,DEB,Amazon UK Marketpl,2.99,,10896.29,Amazon,Swansea,UK
6243,30/11/2015,DEB,Amazon UK Marketpl,2.24,,10899.28,Amazon,Swansea,UK
6244,30/11/2015,DD,UNIV & COL UNION,22.37,,10901.52,Services,Swansea,UK
6245,30/11/2015,BP,SAVE THE CHANGE,0.75,,10923.89,Savings,Swansea,UK
6246,30/11/2015,BGC,SWANSEA UNIVERSITY,,3199.54,10924.64,Supplementary Income,Swansea,UK
6247,27/11/2015,DEB,SAINSBURYS - SWANS,12.25,,7725.1,Groceries,Swansea,UK
6248,26/11/2015,CPT,SBY  SWANSEA UPL C,50.0,,7737.35,Other Shopping,Swansea,UK
6249,26/11/2015,BP,SAVE THE CHANGE,0.52,,7787.35,Savings,Swansea,UK
6250,25/11/2015,DEB,Amazon UK Marketpl,22.54,,7787.87,Amazon,Swansea,UK
6251,25/11/2015,DEB,Amazon UK Marketpl,1.94,,7810.41,Amazon,Swansea,UK
6252,25/11/2015,CPT,LOYD WALES UNIV SW,50.0,,7812.35,Cash,Swansea,UK
6253,25/11/2015,BP,SAVE THE CHANGE,2.71,,7862.35,Savings,Swansea,UK
6254,24/11/2015,DEB,Amazon UK Retail,7.99,,7865.06,Amazon,Swansea,UK
6255,24/11/2015,DEB,Amazon UK Marketpl,7.39,,7873.05,Amazon,Swansea,UK
6256,24/11/2015,DEB,Amazon UK Marketpl,6.59,,7880.44,Amazon,Swansea,UK
6257,24/11/2015,DEB,Amazon UK Marketpl,2.25,,7887.03,Amazon,Swansea,UK
6258,24/11/2015,DEB,Amazon UK Marketpl,1.07,,7889.28,Amazon,Swansea,UK
6259,24/11/2015,BP,SAVE THE CHANGE,2.31,,7890.35,Savings,Swansea,UK
6260,23/11/2015,DEB,Amazon UK Retail,16.11,,7892.66,Amazon,Swansea,UK
6261,23/11/2015,DEB,Amazon UK Retail,7.49,,7908.77,Amazon,Swansea,UK
6262,23/11/2015,DEB,Amazon UK Marketpl,30.27,,7916.26,Amazon,Swansea,UK
6263,23/11/2015,DEB,Amazon UK Marketpl,6.89,,7946.53,Amazon,Swansea,UK
6264,23/11/2015,DEB,Amazon UK Marketpl,2.93,,7953.42,Amazon,Swansea,UK
6265,23/11/2015,DD,VIRGIN MEDIA PYMTS,37.78,,7956.35,Bills,Nottingham,UK
6266,20/11/2015,BP,SAVE THE CHANGE,0.9,,7994.13,Savings,Swansea,UK
6267,19/11/2015,DEB,GWR STOKE GIFF SST,26.1,,7995.03,Travel,Bristol,
6268,19/11/2015,BP,SAVE THE CHANGE,1.7,,8021.13,Savings,Swansea,UK
6269,18/11/2015,DEB,IZ *Friska Ltd,5.25,,8022.83,Dine Out,Bristol,UK
6270,18/11/2015,DEB,PREMIER INN4401262,109.05,,8028.08,Hotels,,
6271,18/11/2015,DEB,CLKBANK*COM_REFUND,,39.62,8137.13,Supplementary Income,Swansea,UK
6272,17/11/2015,CPT,LNK UNION STREET,20.0,,8097.51,Cash,,
6273,17/11/2015,BP,SAVE THE CHANGE,2.95,,8117.51,Savings,Swansea,UK
6274,16/11/2015,DEB,Amazon UK Marketpl,13.64,,8120.46,Amazon,Swansea,UK
6275,16/11/2015,DEB,Amazon UK Retail,4.72,,8134.1,Amazon,Swansea,UK
6276,16/11/2015,DEB,Amazon UK Marketpl,2.02,,8138.82,Amazon,Swansea,UK
6277,16/11/2015,DEB,Amazon UK Marketpl,0.82,,8140.84,Amazon,Swansea,UK
6278,16/11/2015,DEB,Amazon UK Retail,27.46,,8141.66,Amazon,Swansea,UK
6279,16/11/2015,DEB,Amazon UK Marketpl,3.39,,8169.12,Amazon,Swansea,UK
6280,16/11/2015,DD,O2,19.02,,8172.51,Other Shopping,Swansea,UK
6281,13/11/2015,BP,SAVE THE CHANGE,0.85,,8191.53,Savings,Swansea,UK
6282,2015-12-11 00:00:00,DEB,Amazon UK Marketpl,11.95,,8192.38,Amazon,Swansea,UK
6283,2015-12-11 00:00:00,DEB,Amazon UK Retail,5.2,,8204.33,Amazon,Swansea,UK
6284,2015-12-11 00:00:00,BP,SAVE THE CHANGE,0.61,,8209.53,Savings,Swansea,UK
6285,2015-11-11 00:00:00,DEB,Amazon UK Retail,8.39,,8210.14,Amazon,Swansea,UK
6286,2015-11-11 00:00:00,BP,SAVE THE CHANGE,0.62,,8218.53,Savings,Swansea,UK
6287,2015-10-11 00:00:00,DEB,Amazon UK Retail,35.38,,8219.15,Amazon,Swansea,UK
6288,2015-10-11 00:00:00,BP,SAVE THE CHANGE,0.04,,8254.53,Savings,Swansea,UK
6289,2015-09-11 00:00:00,DEB,Amazon UK Marketpl,20.97,,8254.57,Amazon,Swansea,UK
6290,2015-09-11 00:00:00,DEB,Amazon UK Marketpl,4.99,,8275.54,Amazon,Swansea,UK
6291,2015-09-11 00:00:00,DD,LV LIFE,37.12,,8280.53,Insurance,Swansea,UK
6292,2015-09-11 00:00:00,BP,SAVE THE CHANGE,0.99,,8317.65,Savings,Swansea,UK
6293,2015-06-11 00:00:00,DEB,Amazon UK Marketpl,4.01,,8318.64,Amazon,Swansea,UK
6294,2015-06-11 00:00:00,BP,SAVE THE CHANGE,0.72,,8322.65,Savings,Swansea,UK
6295,2015-05-11 00:00:00,DEB,Amazon UK Marketpl,12.99,,8323.37,Amazon,Swansea,UK
6296,2015-05-11 00:00:00,DEB,Amazon UK Retail,9.29,,8336.36,Amazon,Swansea,UK
6297,2015-05-11 00:00:00,BP,SAVE THE CHANGE,1.32,,8345.65,Savings,Swansea,UK
6298,2015-04-11 00:00:00,DEB,Amazon UK Marketpl,9.59,,8346.97,Amazon,Swansea,UK
6299,2015-04-11 00:00:00,DEB,Amazon UK Marketpl,4.09,,8356.56,Amazon,Swansea,UK
6300,2015-04-11 00:00:00,BP,SAVE THE CHANGE,1.38,,8360.65,Savings,Swansea,UK
6301,2015-03-11 00:00:00,DEB,Amazon UK Marketpl,57.47,,8362.03,Amazon,Swansea,UK
6302,2015-03-11 00:00:00,DEB,Amazon UK Retail,12.39,,8419.5,Amazon,Swansea,UK
6303,2015-03-11 00:00:00,DD,ASSURANT INTER LTD,35.56,,8431.89,Insurance,Swansea,UK
6304,2015-03-11 00:00:00,DEB,NON-STG PURCH FEE,1.0,,8467.45,Others,Swansea,UK
6305,2015-03-11 00:00:00,DEB,NON-STG TRANS FEE,27.2,,8468.45,Others,Swansea,UK
6306,2015-03-11 00:00:00,DEB,HILTON HOTELS PALM,909.76,,8495.65,Hotels,,
6307,2015-03-11 00:00:00,BP,SAVE THE CHANGE,0.46,,9405.41,Savings,Swansea,UK
6308,2015-02-11 00:00:00,FEE,ACCOUNT FEE,9.95,,9405.87,Bills,Swansea,UK
6309,2015-02-11 00:00:00,,INTEREST (NET),,5.23,9415.82,Interest,Swansea,UK
6310,2015-02-11 00:00:00,DEB,Amazon UK Marketpl,1.59,,9410.59,Amazon,Swansea,UK
6311,2015-02-11 00:00:00,DEB,Amazon UK Marketpl,3.95,,9412.18,Amazon,Swansea,UK
6312,2015-02-11 00:00:00,DD,NATWEST BANK,748.13,,9416.13,Mortgage,Swansea,UK
6313,2015-02-11 00:00:00,DD,GOOD ENERGY GAS,43.0,,10164.26,Bills,Swansea,UK
6314,2015-02-11 00:00:00,DD,DWR CYMRU W WATER,14.5,,10207.26,Bills,Swansea,UK
6315,2015-02-11 00:00:00,DD,GOOD ENERGY LTD,13.0,,10221.76,Bills,Swansea,UK
6316,2015-02-11 00:00:00,DD,TV LICENCE MBP,12.12,,10234.76,Bills,Swansea,UK
6317,2015-02-11 00:00:00,SO,ESAVINGS ACCOUNT,300.0,,10246.88,Savings,Swansea,UK
6318,2015-02-11 00:00:00,BP,SAVE THE CHANGE,1.14,,10546.88,Savings,Swansea,UK
6319,30/10/2015,DD,UNIV & COL UNION,22.37,,10548.02,Services,Swansea,UK
6320,30/10/2015,DEB,NON-STG CASH FEE,2.0,,10570.39,Others,Swansea,UK
6321,30/10/2015,DEB,NON-STG TRANS FEE,3.91,,10572.39,Others,Swansea,UK
6322,30/10/2015,DEB,17 E MONROE ST LBB,130.94,,10576.3,Services,Swansea,UK
6323,30/10/2015,DEB,NON-STG PURCH FEE,1.0,,10707.24,Others,Swansea,UK
6324,30/10/2015,DEB,NON-STG TRANS FEE,0.74,,10708.24,Others,Swansea,UK
6325,30/10/2015,DEB,FEELINGS GIFT SHOP,25.03,,10708.98,Other Shopping,,
6326,30/10/2015,DEB,NON-STG PURCH FEE,1.0,,10734.01,Others,Swansea,UK
6327,30/10/2015,DEB,NON-STG TRANS FEE,0.32,,10735.01,Others,Swansea,UK
6328,30/10/2015,DEB,FRESHII - 653,10.83,,10735.33,Dine Out,,
6329,30/10/2015,BP,SAVE THE CHANGE,0.18,,10746.16,Savings,Swansea,UK
6330,30/10/2015,BGC,SWANSEA UNIVERSITY,,3064.27,10746.34,Supplementary Income,Swansea,UK
6331,29/10/2015,DEB,NON-STG PURCH FEE,1.0,,7682.07,Others,Swansea,UK
6332,29/10/2015,DEB,NON-STG TRANS FEE,3.1,,7683.07,Others,Swansea,UK
6333,29/10/2015,DEB,SKECHERS-USA #229,103.82,,7686.17,Other Shopping,,
6334,29/10/2015,BP,SAVE THE CHANGE,0.35,,7789.99,Savings,Swansea,UK
6335,28/10/2015,DEB,NON-STG PURCH FEE,1.0,,7790.34,Others,Swansea,UK
6336,28/10/2015,DEB,NON-STG TRANS FEE,0.88,,7791.34,Others,Swansea,UK
6337,28/10/2015,DEB,ITALIAN VILLAGE,29.65,,7792.22,Dine Out,,
6338,28/10/2015,BP,SAVE THE CHANGE,0.01,,7821.87,Savings,Swansea,UK
6339,27/10/2015,DEB,CITY FLOWERS,9.99,,7821.88,Other Shopping,Nottingham,UK
6340,27/10/2015,BP,SAVE THE CHANGE,0.26,,7831.87,Savings,Swansea,UK
6341,26/10/2015,DEB,NON-STG PURCH FEE,1.0,,7832.13,Others,Swansea,UK
6342,26/10/2015,DEB,NON-STG TRANS FEE,4.5,,7833.13,Others,Swansea,UK
6343,26/10/2015,DEB,HILTON HOTELS PALM,150.74,,7837.63,Hotels,,
6344,26/10/2015,BP,SAVE THE CHANGE,0.6,,7988.37,Savings,Swansea,UK
6345,23/10/2015,DEB,SUSU TRADING LTD,59.4,,7988.97,Home Improvement,Swansea,UK
6346,22/10/2015,CPT,LNK FULTON HOUSE,142.86,,8048.37,Cash,Swansea,UK
6347,22/10/2015,CPT,LOYD WALES UNIV SW,150.0,,8191.23,Cash,Swansea,UK
6348,22/10/2015,BP,SAVE THE CHANGE,0.95,,8341.23,Savings,Swansea,UK
6349,21/10/2015,DEB,Amazon UK Marketpl,5.05,,8342.18,Amazon,Swansea,UK
6350,21/10/2015,DD,VIRGIN MEDIA PYMTS,37.78,,8347.23,Bills,Nottingham,UK
6351,21/10/2015,BP,SAVE THE CHANGE,0.05,,8385.01,Savings,Swansea,UK
6352,20/10/2015,DEB,Amazon UK Marketpl,3.95,,8385.06,Amazon,Swansea,UK
6353,20/10/2015,BP,SAVE THE CHANGE,0.33,,8389.01,Savings,Swansea,UK
6354,19/10/2015,DEB,JS ONLINE GROCERY,242.7,,8389.34,Groceries,Swansea,UK
6355,19/10/2015,DEB,Amazon UK Marketpl,6.97,,8632.04,Amazon,Swansea,UK
6356,19/10/2015,DEB,JS ONLINE GROCERY,,4.4,8639.01,Supplementary Income,Swansea,UK
6357,16/10/2015,CPT,LOYD WALES UNIV SW,50.0,,8634.61,Cash,Swansea,UK
6358,16/10/2015,DD,O2,32.55,,8684.61,Other Shopping,Swansea,UK
6359,16/10/2015,BP,SAVE THE CHANGE,0.05,,8717.16,Savings,Swansea,UK
6360,15/10/2015,DEB,Amazon UK Marketpl,24.95,,8717.21,Amazon,Swansea,UK
6361,15/10/2015,BP,SAVE THE CHANGE,0.1,,8742.16,Savings,Swansea,UK
6362,14/10/2015,DEB,Amazon UK Marketpl,9.9,,8742.26,Amazon,Swansea,UK
6363,14/10/2015,BP,SAVE THE CHANGE,0.57,,8752.16,Savings,Swansea,UK
6364,13/10/2015,DEB,Amazon UK Marketpl,11.95,,8752.73,Amazon,Swansea,UK
6365,13/10/2015,DEB,Amazon UK Marketpl,4.48,,8764.68,Amazon,Swansea,UK
6366,13/10/2015,BP,SAVE THE CHANGE,0.32,,8769.16,Savings,Swansea,UK
6367,2015-12-10 00:00:00,DEB,CLKBANK*COM_YS2DQ7,16.68,,8769.48,,,
6368,2015-12-10 00:00:00,BP,SAVE THE CHANGE,0.21,,8786.16,Savings,Swansea,UK
6369,2015-09-10 00:00:00,DEB,Amazon UK Marketpl,6.79,,8786.37,Amazon,Swansea,UK
6370,2015-09-10 00:00:00,DD,LV LIFE,37.12,,8793.16,Insurance,Swansea,UK
6371,2015-09-10 00:00:00,BP,SAVE THE CHANGE,0.63,,8830.28,Savings,Swansea,UK
6372,2015-08-10 00:00:00,DEB,Amazon Svcs Europe,17.4,,8830.91,Amazon,,
6373,2015-08-10 00:00:00,DEB,Amazon UK Retail,8.97,,8848.31,Amazon,Swansea,UK
6374,2015-08-10 00:00:00,BP,SAVE THE CHANGE,0.32,,8857.28,Savings,Swansea,UK
6375,2015-07-10 00:00:00,DEB,Amazon UK Marketpl,13.99,,8857.6,Amazon,Swansea,UK
6376,2015-07-10 00:00:00,DEB,Amazon UK Marketpl,4.69,,8871.59,Amazon,Swansea,UK
6377,2015-07-10 00:00:00,CHQ,42,418.0,,8876.28,Cash,Swansea,UK
6378,2015-07-10 00:00:00,BP,SAVE THE CHANGE,0.74,,9294.28,Savings,Swansea,UK
6379,2015-06-10 00:00:00,DEB,ITUNES.COM/BILL,3.99,,9295.02,Bills,Swansea,UK
6380,2015-06-10 00:00:00,DEB,Amazon UK Marketpl,1.27,,9299.01,Amazon,Swansea,UK
6381,2015-06-10 00:00:00,BP,SAVE THE CHANGE,2.01,,9300.28,Savings,Swansea,UK
6382,2015-05-10 00:00:00,DEB,Amazon UK Retail,12.99,,9302.29,Amazon,Swansea,UK
6383,2015-05-10 00:00:00,DEB,Amazon UK Marketpl,7.98,,9315.28,Amazon,Swansea,UK
6384,2015-05-10 00:00:00,DEB,Amazon UK Marketpl,7.66,,9323.26,Amazon,Swansea,UK
6385,2015-05-10 00:00:00,DEB,Amazon UK Marketpl,6.95,,9330.92,Amazon,Swansea,UK
6386,2015-05-10 00:00:00,DEB,Amazon UK Marketpl,6.95,,9337.87,Amazon,Swansea,UK
6387,2015-05-10 00:00:00,DEB,Amazon UK Marketpl,6.23,,9344.82,Amazon,Swansea,UK
6388,2015-05-10 00:00:00,DEB,Amazon UK Marketpl,5.88,,9351.05,Amazon,Swansea,UK
6389,2015-05-10 00:00:00,DEB,Amazon UK Marketpl,4.35,,9356.93,Amazon,Swansea,UK
6390,2015-05-10 00:00:00,DD,ASSURANT INTER LTD,35.56,,9361.28,Insurance,Swansea,UK
6391,2015-05-10 00:00:00,BP,SAVE THE CHANGE,2.5,,9396.84,Savings,Swansea,UK
6392,2015-02-10 00:00:00,DEB,NATIONAL WESTMINST,1030.0,,9399.34,Mortgage,Swansea,UK
6393,2015-02-10 00:00:00,DEB,Amazon UK Marketpl,17.16,,10429.34,Amazon,Swansea,UK
6394,2015-02-10 00:00:00,DEB,Amazon UK Marketpl,11.1,,10446.5,Amazon,Swansea,UK
6395,2015-02-10 00:00:00,DEB,Amazon UK Marketpl,3.24,,10457.6,Amazon,Swansea,UK
6396,2015-02-10 00:00:00,CPT,LOYD WALES UNIV SW,50.0,,10460.84,Cash,Swansea,UK
6397,2015-02-10 00:00:00,BP,SAVE THE CHANGE,0.52,,10510.84,Savings,Swansea,UK
6398,2015-01-10 00:00:00,FEE,ACCOUNT FEE,9.95,,10511.36,Bills,Swansea,UK
6399,2015-01-10 00:00:00,,INTEREST (NET),,4.9,10521.31,Interest,Swansea,UK
6400,2015-01-10 00:00:00,DEB,Amazon UK Retail,17.49,,10516.41,Amazon,Swansea,UK
6401,2015-01-10 00:00:00,DEB,Amazon UK Retail,14.99,,10533.9,Amazon,Swansea,UK
6402,2015-01-10 00:00:00,DD,NATWEST BANK,748.13,,10548.89,Mortgage,Swansea,UK
6403,2015-01-10 00:00:00,DD,CC SWANSEA C.TAX,122.0,,11297.02,Bills,Swansea,UK
6404,2015-01-10 00:00:00,DD,GOOD ENERGY GAS,43.0,,11419.02,Bills,Swansea,UK
6405,2015-01-10 00:00:00,DD,DWR CYMRU W WATER,14.5,,11462.02,Bills,Swansea,UK
6406,2015-01-10 00:00:00,DD,GOOD ENERGY LTD,13.0,,11476.52,Bills,Swansea,UK
6407,2015-01-10 00:00:00,DD,TV LICENCE MBP,12.12,,11489.52,Bills,Swansea,UK
6408,2015-01-10 00:00:00,SO,ESAVINGS ACCOUNT,300.0,,11501.64,Savings,Swansea,UK
6409,2015-01-10 00:00:00,BP,SAVE THE CHANGE,1.01,,11801.64,Savings,Swansea,UK
6410,30/09/2015,DEB,Amazon UK Marketpl,5.04,,11802.65,Amazon,Swansea,UK
6411,30/09/2015,DEB,Amazon UK Marketpl,4.95,,11807.69,Amazon,Swansea,UK
6412,30/09/2015,DD,UNIV & COL UNION,22.37,,11812.64,Services,Swansea,UK
6413,30/09/2015,BP,SAVE THE CHANGE,0.76,,11835.01,Savings,Swansea,UK
6414,30/09/2015,BGC,SWANSEA UNIVERSITY,,3043.03,11835.77,Supplementary Income,Swansea,UK
6415,29/09/2015,DEB,UPLANDS CHIROPRACT,50.0,,8792.74,Health,Swansea,UK
6416,29/09/2015,DEB,Amazon UK Marketpl,3.24,,8842.74,Amazon,Swansea,UK
6417,29/09/2015,BP,SAVE THE CHANGE,1.89,,8845.98,Savings,Swansea,UK
6418,28/09/2015,DEB,Amazon UK Retail,11.34,,8847.87,Amazon,Swansea,UK
6419,28/09/2015,DEB,CLKBANK*COM_RGEHNH,39.62,,8859.21,,,
6420,28/09/2015,DEB,Amazon Svcs Europe,2.15,,8898.83,Amazon,Swansea,UK
6421,25/09/2015,CPT,LOYD WALES UNIV SW,50.0,,8900.98,Cash,Swansea,UK
6422,25/09/2015,BGC,SWANSEA UNIVERSITY,,429.29,8950.98,Supplementary Income,Swansea,UK
6423,24/09/2015,BP,SAVE THE CHANGE,0.16,,8521.69,Savings,Swansea,UK
6424,23/09/2015,DEB,Amazon UK Marketpl,0.84,,8521.85,Amazon,Swansea,UK
6425,22/09/2015,BP,SAVE THE CHANGE,3.73,,8522.69,Savings,Swansea,UK
6426,21/09/2015,DEB,CYCLECHIC LTD,83.49,,8526.42,Other Shopping,Swansea,
6427,21/09/2015,DEB,AMAZON MKTPLACE PM,15.01,,8609.91,Amazon,Swansea,UK
6428,21/09/2015,DEB,Amazon UK Marketpl,8.0,,8624.92,Amazon,Swansea,UK
6429,21/09/2015,DEB,Amazon UK Marketpl,12.96,,8632.92,Amazon,Swansea,UK
6430,21/09/2015,DEB,Amazon Svcs Europe,39.11,,8645.88,Amazon,Swansea,UK
6431,21/09/2015,DEB,Amazon UK Marketpl,3.11,,8684.99,Amazon,Swansea,UK
6432,21/09/2015,DEB,Amazon UK Marketpl,1.59,,8688.1,Amazon,Swansea,UK
6433,21/09/2015,DD,VIRGIN MEDIA PYMTS,35.45,,8689.69,Bills,Swansea,UK
6434,21/09/2015,BP,SAVE THE CHANGE,0.51,,8725.14,Savings,Swansea,UK
6435,18/09/2015,DEB,Amazon UK Retail,5.49,,8725.65,Amazon,Swansea,UK
6436,16/09/2015,DEB,IBIS BRISTOL TEMPL,110.0,,8731.14,Hotels,Bristol,
6437,16/09/2015,DD,O2,17.41,,8841.14,Other Shopping,Swansea,UK
6438,2015-09-09 00:00:00,DD,LV LIFE,37.12,,8858.55,Insurance,Swansea,UK
6439,2015-07-09 00:00:00,DEB,LIFELOADED LTD,,62.83,8895.67,Supplementary Income,Swansea,UK
6440,2015-07-09 00:00:00,BP,SAVE THE CHANGE,0.45,,8832.84,Savings,Swansea,UK
6441,2015-04-09 00:00:00,DEB,JS ONLINE GROCERY,152.56,,8833.29,Groceries,Swansea,UK
6442,2015-04-09 00:00:00,DEB,Amazon UK Retail,5.99,,8985.85,Amazon,Swansea,UK
6443,2015-04-09 00:00:00,DEB,FGW WEBSALES,94.0,,8991.84,Travel,Bristol,UK
6444,2015-04-09 00:00:00,BP,SAVE THE CHANGE,0.01,,9085.84,Savings,Swansea,UK
6445,2015-03-09 00:00:00,DEB,Amazon UK Marketpl,14.99,,9085.85,Amazon,Swansea,UK
6446,2015-03-09 00:00:00,CHQ,41,375.0,,9100.84,Cash,Swansea,UK
6447,2015-03-09 00:00:00,DD,ASSURANT INTER LTD,35.59,,9475.84,Insurance,Swansea,UK
6448,2015-03-09 00:00:00,BP,SAVE THE CHANGE,2.31,,9511.43,Savings,Swansea,UK
6449,2015-02-09 00:00:00,DEB,Amazon UK Marketpl,38.48,,9513.74,Amazon,Swansea,UK
6450,2015-02-09 00:00:00,DEB,Amazon UK Retail,20.17,,9552.22,Amazon,Swansea,UK
6451,2015-02-09 00:00:00,DEB,Amazon UK Marketpl,6.53,,9572.39,Amazon,Swansea,UK
6452,2015-02-09 00:00:00,DEB,NON-STG PURCH FEE,1.0,,9578.92,Others,Swansea,UK
6453,2015-02-09 00:00:00,DEB,NON-STG TRANS FEE,1.86,,9579.92,Others,Swansea,UK
6454,2015-02-09 00:00:00,DEB,LIFELOADED LTD,62.51,,9581.78,,Swansea,UK
6455,2015-02-09 00:00:00,BP,SAVE THE CHANGE,0.53,,9644.29,Savings,Swansea,UK
6456,2015-01-09 00:00:00,FEE,ACCOUNT FEE,9.95,,9644.82,Bills,Swansea,UK
6457,2015-01-09 00:00:00,,INTEREST (NET),,4.74,9654.77,Interest,Swansea,UK
6458,2015-01-09 00:00:00,DEB,EASYJET   000EPK,497.96,,9650.03,Travel,,
6459,2015-01-09 00:00:00,DEB,Amazon UK Marketpl,5.51,,10147.99,Amazon,Swansea,UK
6460,2015-01-09 00:00:00,DD,NATWEST BANK,748.13,,10153.5,Mortgage,Swansea,UK
6461,2015-01-09 00:00:00,DD,CC SWANSEA C.TAX,122.0,,10901.63,Bills,Swansea,UK
6462,2015-01-09 00:00:00,DD,GOOD ENERGY GAS,43.0,,11023.63,Bills,Swansea,UK
6463,2015-01-09 00:00:00,DD,DWR CYMRU W WATER,14.5,,11066.63,Bills,Swansea,UK
6464,2015-01-09 00:00:00,DD,GOOD ENERGY LTD,13.0,,11081.13,Bills,Swansea,UK
6465,2015-01-09 00:00:00,DD,TV LICENCE MBP,12.12,,11094.13,Bills,Swansea,UK
6466,2015-01-09 00:00:00,SO,ESAVINGS ACCOUNT,300.0,,11106.25,Savings,Swansea,UK
6467,2015-01-09 00:00:00,BP,SAVE THE CHANGE,1.61,,11406.25,Savings,Swansea,UK
6468,28/08/2015,DEB,Amazon UK Marketpl,12.42,,11407.86,Amazon,Swansea,UK
6469,28/08/2015,DEB,Amazon UK Retail,11.2,,11420.28,Amazon,Swansea,UK
6470,28/08/2015,DEB,Amazon Svcs Europe,2.77,,11431.48,Amazon,Swansea,UK
6471,28/08/2015,CPT,LOYD WALES UNIV SW,30.0,,11434.25,Cash,Swansea,UK
6472,28/08/2015,DD,UNIV & COL UNION,22.37,,11464.25,Services,Swansea,UK
6473,28/08/2015,BP,SAVE THE CHANGE,0.06,,11486.62,Savings,Swansea,UK
6474,28/08/2015,BGC,SWANSEA UNIVERSITY,,3043.03,11486.68,Supplementary Income,Swansea,UK
6475,27/08/2015,DEB,Amazon UK Marketpl,16.99,,8443.65,Amazon,Swansea,UK
6476,27/08/2015,DEB,Amazon Svcs Europe,2.95,,8460.64,Amazon,Swansea,UK
6477,26/08/2015,CPT,LOYD WALES UNIV SW,30.0,,8463.59,Cash,Swansea,UK
6478,26/08/2015,BP,SAVE THE CHANGE,0.44,,8493.59,Savings,Swansea,UK
6479,25/08/2015,DEB,Amazon UK Marketpl,1.56,,8494.03,Amazon,Swansea,UK
6480,25/08/2015,BP,SAVE THE CHANGE,0.4,,8495.59,Savings,Swansea,UK
6481,24/08/2015,DEB,ARRIVA TRAINS WALE,17.6,,8495.99,Travel,,
6482,24/08/2015,CPT,LOYD SWANSEA UNIVE,70.0,,8513.59,Cash,Swansea,UK
6483,24/08/2015,BP,SAVE THE CHANGE,1.15,,8583.59,Savings,Swansea,UK
6484,24/08/2015,FPO,ALAN HOLLAND,140.0,,8584.74,Services,Swansea,UK
6485,21/08/2015,DEB,BIG SLEEP HOTEL,45.0,,8724.74,Hotels,Cardiff,UK
6486,21/08/2015,DEB,ARRIVA TRAINS WALE,17.6,,8769.74,Travel,,
6487,21/08/2015,DEB,Amazon Svcs Europe,5.25,,8787.34,Amazon,Swansea,UK
6488,21/08/2015,DD,VIRGIN MEDIA PYMTS,27.78,,8792.59,Bills,Nottingham,UK
6489,21/08/2015,BP,SAVE THE CHANGE,0.52,,8820.37,Savings,Swansea,UK
6490,20/08/2015,DEB,Amazon UK Marketpl,7.99,,8820.89,Amazon,Swansea,UK
6491,20/08/2015,DEB,Amazon UK Retail,3.49,,8828.88,Amazon,Swansea,UK
6492,20/08/2015,BP,SAVE THE CHANGE,0.8,,8832.37,Savings,Swansea,UK
6493,19/08/2015,DEB,Amazon UK Marketpl,9.2,,8833.17,Amazon,Swansea,UK
6494,19/08/2015,BP,SAVE THE CHANGE,0.78,,8842.37,Savings,Swansea,UK
6495,18/08/2015,DEB,Amazon UK Marketpl,13.25,,8843.15,Amazon,Swansea,UK
6496,18/08/2015,DEB,Amazon UK Marketpl,8.98,,8856.4,Amazon,Swansea,UK
6497,18/08/2015,DEB,Amazon Svcs Europe,5.99,,8865.38,Amazon,Swansea,UK
6498,18/08/2015,BP,SAVE THE CHANGE,2.37,,8871.37,Savings,Swansea,UK
6499,17/08/2015,DEB,ISTANBUL RESTAURAN,56.3,,8873.74,Dine Out,Nottingham,UK
6500,17/08/2015,DEB,Amazon UK Retail,3.0,,8930.04,Amazon,Swansea,UK
6501,17/08/2015,DEB,Amazon UK Marketpl,4.05,,8933.04,Amazon,Swansea,UK
6502,17/08/2015,DEB,Amazon UK Marketpl,4.64,,8937.09,Amazon,Swansea,UK
6503,17/08/2015,DEB,NON-STG PURCH FEE,1.0,,8941.73,Others,Swansea,UK
6504,17/08/2015,DEB,NON-STG TRANS FEE,0.01,,8942.73,Others,Swansea,UK
6505,17/08/2015,DEB,LIFELOADED LTD,0.64,,8942.74,,,
6506,17/08/2015,DD,O2,18.61,,8943.38,Other Shopping,Swansea,UK
6507,17/08/2015,BP,SAVE THE CHANGE,0.05,,8961.99,Savings,Swansea,UK
6508,14/08/2015,DEB,THE BAYVIEW PUB AN,26.95,,8962.04,Dine Out,Sheerness,UK
6509,14/08/2015,CPT,LOYD WALES UNIV SW,20.0,,8988.99,Cash,Swansea,UK
6510,13/08/2015,CPT,LOYD SWANSEA UNIVE,50.0,,9008.99,Cash,Swansea,UK
6511,13/08/2015,BP,SAVE THE CHANGE,0.41,,9058.99,Savings,Swansea,UK
6512,2015-12-08 00:00:00,DEB,Amazon UK Marketpl,1.59,,9059.4,Amazon,Swansea,UK
6513,2015-12-08 00:00:00,BP,SAVE THE CHANGE,0.85,,9060.99,Savings,Swansea,UK
6514,2015-11-08 00:00:00,DEB,HILTON,29.15,,9061.84,Hotels,,
6515,2015-11-08 00:00:00,DEB,HILTON,238.0,,9090.99,Hotels,,
6516,2015-11-08 00:00:00,BP,SAVE THE CHANGE,2.88,,9328.99,Savings,Swansea,UK
6517,2015-10-08 00:00:00,DEB,ARRIVA TRAINS WALE,70.5,,9331.87,Travel,,
6518,2015-10-08 00:00:00,DEB,Amazon UK Retail,14.95,,9402.37,Amazon,Swansea,UK
6519,2015-10-08 00:00:00,DEB,M&S SIMPLY FOOD -,13.41,,9417.32,Groceries,Swansea,UK
6520,2015-10-08 00:00:00,DEB,Amazon UK Marketpl,4.08,,9430.73,Amazon,Swansea,UK
6521,2015-10-08 00:00:00,DEB,Amazon UK Retail,7.0,,9434.81,Amazon,Swansea,UK
6522,2015-10-08 00:00:00,DEB,Amazon Svcs Europe,22.18,,9441.81,Amazon,Swansea,UK
6523,2015-10-08 00:00:00,DD,LV LIFE,37.12,,9463.99,Insurance,Swansea,UK
6524,2015-07-08 00:00:00,CPT,LOYD SWANSEA UNIVE,60.0,,9501.11,Cash,Swansea,UK
6525,2015-07-08 00:00:00,BP,SAVE THE CHANGE,0.62,,9561.11,Savings,Swansea,UK
6526,2015-06-08 00:00:00,DEB,Amazon UK Retail,20.98,,9561.73,Amazon,Swansea,UK
6527,2015-06-08 00:00:00,DEB,Amazon UK Retail,18.94,,9582.71,Amazon,Swansea,UK
6528,2015-06-08 00:00:00,DEB,EXOTICA,15.46,,9601.65,Groceries,Swansea,UK
6529,2015-06-08 00:00:00,BP,SAVE THE CHANGE,0.98,,9617.11,Savings,Swansea,UK
6530,2015-05-08 00:00:00,DEB,EXOTICA,21.0,,9618.09,Groceries,Swansea,UK
6531,2015-05-08 00:00:00,DEB,Amazon UK Marketpl,5.99,,9639.09,Amazon,Swansea,UK
6532,2015-05-08 00:00:00,DEB,Amazon UK Marketpl,5.15,,9645.08,Amazon,Swansea,UK
6533,2015-05-08 00:00:00,DEB,Amazon UK Marketpl,1.88,,9650.23,Amazon,Swansea,UK
6534,2015-05-08 00:00:00,BP,SAVE THE CHANGE,1.07,,9652.11,Savings,Swansea,UK
6535,2015-04-08 00:00:00,DEB,Amazon UK Retail,7.13,,9653.18,Amazon,Swansea,UK
6536,2015-04-08 00:00:00,DEB,Amazon UK Marketpl,2.8,,9660.31,Amazon,Swansea,UK
6537,2015-04-08 00:00:00,BP,SAVE THE CHANGE,0.01,,9663.11,Savings,Swansea,UK
6538,2015-03-08 00:00:00,FEE,ACCOUNT FEE,9.95,,9663.12,Bills,Swansea,UK
6539,2015-03-08 00:00:00,,INTEREST (NET),,5.4,9673.07,Interest,Swansea,UK
6540,2015-03-08 00:00:00,DEB,Amazon Svcs Europe,89.99,,9667.67,Amazon,Swansea,UK
6541,2015-03-08 00:00:00,CPT,LOYD WALES UNIV SW,50.0,,9757.66,Cash,Swansea,UK
6542,2015-03-08 00:00:00,DD,NATWEST BANK,748.13,,9807.66,Mortgage,Swansea,UK
6543,2015-03-08 00:00:00,DD,CC SWANSEA C.TAX,122.0,,10555.79,Bills,Swansea,UK
6544,2015-03-08 00:00:00,DD,GOOD ENERGY GAS,71.0,,10677.79,Bills,Swansea,UK
6545,2015-03-08 00:00:00,DD,GOOD ENERGY LTD,43.0,,10748.79,Bills,Swansea,UK
6546,2015-03-08 00:00:00,DD,ASSURANT INTER LTD,35.56,,10791.79,Insurance,Swansea,UK
6547,2015-03-08 00:00:00,DD,DWR CYMRU W WATER,22.5,,10827.35,Bills,Swansea,UK
6548,2015-03-08 00:00:00,DD,TV LICENCE MBP,12.12,,10849.85,Bills,Swansea,UK
6549,2015-03-08 00:00:00,SO,ESAVINGS ACCOUNT,300.0,,10861.97,Savings,Swansea,UK
6550,2015-03-08 00:00:00,BP,SAVE THE CHANGE,0.5,,11161.97,Savings,Swansea,UK
6551,2015-03-08 00:00:00,BGC,STFC AP,,585.29,11162.47,Supplementary Income,Swansea,UK
6552,31/07/2015,DEB,ARRIVA TRAINS WALE,33.5,,10577.18,Travel,,
6553,31/07/2015,DD,UNIV & COL UNION,22.37,,10610.68,Services,Swansea,UK
6554,31/07/2015,BP,SAVE THE CHANGE,0.2,,10633.05,Savings,Swansea,UK
6555,31/07/2015,BGC,SWANSEA UNIVERSITY,,3042.63,10633.25,Supplementary Income,Swansea,UK
6556,31/07/2015,BGC,SWANSEA UNIVERSITY,,503.36,7590.62,Supplementary Income,Swansea,UK
6557,30/07/2015,DEB,Amazon UK Marketpl,6.8,,7087.26,Amazon,Swansea,UK
6558,30/07/2015,BP,SAVE THE CHANGE,0.52,,7094.06,Savings,Swansea,UK
6559,29/07/2015,DEB,Amazon UK Marketpl,17.94,,7094.58,Amazon,Swansea,UK
6560,29/07/2015,DEB,Amazon Svcs Europe,4.54,,7112.52,Amazon,Swansea,UK
6561,29/07/2015,CPT,LOYD SWANSEA UNIVE,70.0,,7117.06,Cash,Swansea,UK
6562,29/07/2015,BP,SAVE THE CHANGE,0.51,,7187.06,Savings,Swansea,UK
6563,28/07/2015,DEB,Amazon Svcs Europe,5.49,,7187.57,Amazon,Swansea,UK
6564,28/07/2015,BP,SAVE THE CHANGE,1.1,,7193.06,Savings,Swansea,UK
6565,27/07/2015,DEB,Amazon UK Marketpl,6.39,,7194.16,Amazon,Swansea,UK
6566,27/07/2015,DEB,JS ONLINE GROCERY,316.51,,7200.55,Groceries,Swansea,UK
6567,27/07/2015,FPO,ALAN HOLLAND,1000.0,,7517.06,Services,Swansea,UK
